lang.EN=英文
lang.GB=GB
label.Page=页
label.Total=总数
label.Records=记录

combobox.notselected=未选择
validate.prompt=输入不正确
validate.list.required=必须
validate.list.required.prompt2={0} 是必须的
validate.list.required.prompt=请选择{0}
validate.required=必须
validate.required.prompt={0} 是必须的
validate.date=日子不正确
validate.date.prompt={0} 并非正确日子
validate.double=数子不正确
validate.double.prompt={0} 并非正确数字
validate.int= 数子不正确
validate.int.prompt={0} 并非正确整数
validate.intrange={0} 超出范围
validate.toobig=数值过大
validate.toobig.prompt={0} 过大
validate.toosmall=数值过少
validate.toosmall.prompt={0} 过少
validate.posnum=是一个正数
validate.posnum.prompt={0} 并非一个正数
validate.maxlength=数值过长
validate.maxlength.prompt={0} 过长


AVC below MAX=少于或等于最高有关入息时的供款百分比
AVC above MAX=大于最高有关入息时的供款百分比
Accommodation=住处
Bank Account Number=银行户口号码
Account No=户口号码
Additional Voluntary Contribution=自愿性供款
Additional Voluntary Contribution Plan=自愿性供款计划
Address=地址
Address of Employer=雇主地址
Adj Type=调整类别
Adjust=调整
Adjust Date=调整日期
Alias=别名
Amount=款额
Amount with unit=款额
Any money held under Section 52(7) of the Inland Revenue Ordinance=有无依据税务条例第52(7)条规定扣起任何款项
As Of Date=指定日期
Attendance From=考勤由
Attendance Period=考勤周期
Attendance To=考勤至
AVC Plan=自愿性供款计划
AVC Plan List=自愿性供款计划序列
AVC Plan Search=自愿性供款计划搜寻
AVC Plan Setup=自愿性供款计划设定
Balance=结余
Bank Account=银行户口
Bank Account No=银行户口号码
Bank Code=银行代号
Bank File Type=银行档案类别
BF=带假
BR=商业登记证
BR No.=商业登记证号码
Branch Code=分行代号
Business Hierarchy List=商业层级序列
Business Hierarchy Search=搜寻商业层级
Business Hierarchy Setup=商业层级设定
Capacity in which employed=受雇职位
Cessation Reason=离职原因
Change Password=更改密码
Change Password Period=更改密码周期
Chinese Name=中文姓名
CitiBank File Detail=花旗银行自动转脤档案
Claims and Deductions=索偿与扣减
Claims and Deductions Detail=索偿与扣减详情
Code=代号
Company=公司
Company Address=公司地址
Company BR No=公司商业登记证号码
Company Code=公司代号
Company Contact Person=公司联络人
Company List=公司序列
Company Name=公司名称
Company Search=公司搜寻
Company Setup=公司设定
Confirm=确认
Confirm Date=确认日期
Confirm New Password=确认新密码
Confirm Password=确认密码
Contact Name=联络人名称
Contract No.=合约号码
Contact No.=联络号码
Contact Person=联络人
Contracts=合约
Contribute for age over MPF maximum age limit=超过强积金最高年龄限制时仍继续供款
Contribute for income less than MPF minimum relevant income=低于最低有关入息时仍继续供款
Correspondence=通讯地址
Postal Address=通讯地址
Postal address after departure=离港后的通讯地址
Country Issued=发证国家
Current=现在
Current Date=现在日期
Customer Reference=用户参考
Date=日期
Date From=由
Date of Birth=出生日期
Date of Grant=发给认购权日期
Date of Joining=入职日期
Date Range=日期范围
Date To=至
Day=日
Days Entitled=应得日数
Days Taken=已取日数
Decimal Place=小数位
Default Next Period From=由预设下一周期
Default Next Period To=至预设下一周期
Dependant=家属
Desc=描述
Description=描述
Designation=职位
Detail=详情
Edit=编辑
Edit  Employee Profile=编辑雇员数据
Edit Accommodation=编辑住处
Edit AVC Plan=编辑自愿性供款计划
Edit Bank Account=编辑银行户口
Edit Business Hierarchy=编辑商业层级
Edit Contract Terms=编辑合约条款
Edit Dependant=编辑家属
Edit Employee Skill=编辑雇员技能
Edit Final Payment=编辑最后工资
Edit Leave Adjustment=编辑休假调整
Edit Leave Application=编辑休假申请
Edit Leave Type=编辑休假类别
Edit MPF Plan=编辑强积金计划
Edit ORSO Plan=编辑职业退休计划
Edit P-Fund Plan=编辑公积金计划
Edit Payment Code=编辑支薪代号
Edit Payroll Cycle=编辑支薪周期
Edit Payroll Formula=编辑支薪公式
Edit Payroll Group=编辑支薪组别
Edit Position Information=编辑职位数据
Edit Qualification=编辑学历
Qualification=学历
Edit Recurring Payment=编辑定期支薪
Edit Spouse=编辑配偶数据
Edit Taxation Category Mapping=编辑税务种类配对
Edit Taxation Company=编辑税务公司
Edit User=编辑用户
Edit User Group=编辑用户组别
Effective Date=生效日期
Effective From=生效由
Personal E-mail Address=私人电邮地址
Emp No=雇员编号
Employee=雇员
Employee AVC exemption period the same as MPF=雇员的自愿性供款可享有强积金的免供款期
Employee Cont.=雇员供款
Employee Contact=雇员联络
Employee Contact Report=雇员联络报告
Employee Contribution=雇员供款
Employee Daily Average Wages Report=雇员平均工资报告
Employee Detail=雇员详情报告
Employee Details Report=雇员详情报告
Employee Head Count=雇员人数
Employee Head Count Report=雇员人数报告
Employee Info=雇员资料
Employee Information=雇员资料
Employee List=雇员序列
Employee List Report=雇员名单报告
Employee Name=雇员名称
Employee No=雇员编号
Employee Overall Payment Summary=雇员整体支薪摘要
Employee Profile=雇员资料
Employee Report=雇员报告
Employee Search=搜寻雇员
Employee Setup=雇员设定
Employee Termination List=离职雇员名单
Employer=雇主
Employer Cont.=雇主供款
Employer Contribution=雇主供款
Employment Type=雇用型式
EmpNo=雇员编号
End=终结
estimated amount=估计款额
Existing Employee=现职雇员
Expiry Date=有效日期
Expiry After must be 0 when Max Days B/F is 0=没有带假情况下, 请于有效月数输入0
Fax=传真
Fax No.=传真号码
Final Pay Amount=最后工资款额
Final Payment Details=最后工资详细资料
Final Payment Prorata Formula=最后工资比例公式
First Party Reference=第一方参考编号
First Period End Day=第一周期终结日
First Period Start Day=第一周期开始日
Fix Contribution Amount=固定供款额
Form=表格
Formula=公式
Formula Code=公式代号
Frequency=频率
From=由
Function Permissions=允许功能
Future Postal Address of Employee=雇员将来的通讯地址
Gender=性别
Generate Bank File (By Payroll Group)=制作银行档案 (根据支薪组别)
Generate Bank File (By Payroll Cycle)=制作银行档案 (根据支薪期)
Generated By=制作者
Gratuity=赏金
Hierarchy Level=公司架构
Hierarchy Level Setup=公司架构设定
HKID=香港身份证号码
Holder Name=持有人名称
Home=住宅电话号码
HSBC/Hang Seng Bank File Detail=香港汇丰银行及恒生银行自动转账档案
Part time Employer Name=如为兼职， 他/她主要职业的雇主名称
Institute=学校或机构名称
Is AutoGen=是否自动计算
Is Default Account=是否预设户口
Is MPF=是否强积金有关入息
Is P-Fund=是否公积金有关入息
Pro-rata Options=比例计算选项
Pro-rata when new join/terminated=当 新入职 / 离职 时按比例计算
Pro-rata for Leave=请假时按比例计算
Pro-rata for Statutory Holiday=法定假期时按比例计算
Is Voluntary=是否自愿性供款有关入息
Is Wages=是否工资
Join Date=入职日期
Landlord=房东名称
Landlord Address=房东地址
Last Date=最后工作日期
Last Employment Date=最后工作日期
Last Generation Date=最后制作日期
Leave=休假
Leave Adjustment=休假调整
Leave Allowance Formula=休假津贴公式
Leave Application & History Enquiry=休假申请及查询休假纪录
Leave Application cut off Date=休假申请截数日
Leave Balance=休假结余
Leave Code=休假代号
Leave Code Search=搜寻休假代号
Leave Code Setup=休假代号设定
Leave Cut off Date=休假截数日
Leave Deduction Formula=休假扣减公式
Leave Hong Kong Date=离港日期
Leave Plan=休假计划
Leave Plan Entitlement=休假计划应得的权利
Leave Plan List=休假计划序列
Leave Plan Search=搜寻休假计划
Leave Plan Setup=休假计划设定
Leave Recalculation=重新计算休假
Leave Summary=休假摘要
Leave Summary Report=休假摘要报告
Leave Type=休假类别
Leave Type List=休假类别序列
Leave Type Search=搜寻休假类别
Leave Type Setup=休假类别设定
Level=级别
Login Fail Count=登入失败次数
Long Service Pay=长期服务金
Marital Status=婚姻状况
Martial Status=婚姻状况
Max AL=最多有薪假期
Max Daily=最多日薪供款
Max Monthly=最多月薪供款
Max SL I=最多病假类别I
Max SL II=最多病假类别II
Max. 12 character=最多12个位
Max. 16 character=最多16个位
Max. 3 character=最多3个位
Max. Annual Leave BF=有薪假期最多带假日数
Max. employee's contribution=雇员供款上限
Max. employee's voluntary contribution=雇员自愿性供款上限
Max. employer's contribution=雇主供款上限
Max. employer's voluntary contribution=雇主自愿性供款上限
Max. Sick Leave Cat I BF=病假类别I最多带假日数
Max. Sick Leave Cat II BF=病假类别II最多带假日数
Method=方式
Min Daily=最少日薪供款
Min Monthly=最少月薪供款
Miscellaneous Code Setup=杂项代号设定
Mobile No.=手提电话号码
Monthly Payment x=每月工资 x
MPF Detail=强积金详情
MPF Details List=强积金详情清单
MPF Parameter : - Edit=编辑强积金参数
MPF Parameter ID=强积金参数编号
MPF Parameter List=强积金参数序列
MPF Parameter Name=强积金参数名称
MPF Parameter Search=搜寻强积金参数
MPF Parameter Setup=强积金参数设定
MPF Plan=强积金计划
MPF Plan List=强积金计划序列
MPF Plan Search=搜寻强积金计划
MPF Plan Setup=强积金计划设定
MPF Remittance Statement=强积金付款结算书
MPFEE=雇员强积金供款
MPFER=雇主强积金供款
Name=名称
Name and address of previous Hong Kong Employer=如以前曾在香港受雇 ，请叙明该雇主(商号)的名称及地址
Name of Employer=雇主名称
Name of overseas company=海外公司名称
Name of Signature=签名人姓名
Nationality=国籍
Nature=类型
Need to Change Password=登入后需要更改密码
New employer name and address=新雇主的名称及地址
New Join Employee=新入职雇员
New Join Prorata Formula=新入职的按比例计算公式
New Password=新密码
Next=下一个
No Payroll Process=不要作支薪处理
no. of shares not yet exercised=未行使的认购股份数目
Notice Period=通知期
Occupational Retirement Schemes Ordinance Plan=职业退休计划
Office=办公室电话号码
Old=过去的
Old Password=旧密码
ORSO Plan=职业退休计划
ORSO Plan List=职业退休计划序列
ORSO Plan Search=搜寻职业退休计划
ORSO Plan Setup=职业退休计划设定
P-Fund Plan=公积金计划
P-Fund Plan List=公积金计划序列
P-Fund Plan Setup=公积金计划设定
P-Fund Plan Search=搜寻公积金计划
Other Name=名字
Other Name in Full=其他名字
Passport No.=护照号码
Passport No=护照号码
Passport Country=签发国家
Passport Expiry Date=护照有效日期
Passport Issued Country=护照签发国家
Password=密码
Payment Comparison=比较款额
Pay Advance=预付
Pay Center=付款中心
Pay Group=支薪组别
Pay Method=支薪方式
Pay Ratio=比率
Pay Slip Report=支薪通知书
PayCodeID=支薪代号
Payment=支薪项目
Payment Code=支薪代号
Payment Code for Leave Allowance=休假津贴的支薪代号
Payment Code for Leave Deduction=休假扣减的支薪代号
Payment Code for Statutory Holiday Allowance=法定假期津贴的支薪代号
Payment Code for Statutory Holiday Deduction=法定假期扣减的支薪代号
Payment Code List=支薪代号序列
Payment Code Search=搜寻支薪代号
Payment Code Setup=支薪代号设定
Payment Detail=支薪详情
Payment List=入息明细
Payment Type=支薪类别
Payroll=支薪
Payroll & MPF Report=支薪及强积金报告
Payroll Batch List=支薪档案夹序列
Payroll Confirmation=支薪确认
Payroll Cycle=支薪周期
Payroll Cycle Information=支薪周期资料
Payroll Cycle Reference Date=支薪周期参考日期
Payroll Discrepancy List=支薪相差清单
Payroll Formula Setup=支薪公式设定
Payroll Formula List=支薪公式序列
Payroll Formula Search=搜寻支薪公式
Payroll Group=支薪组别
Payroll Group Setup=支薪组别设定
Payroll Group Information=支薪组别资料
Payroll Group List=支薪组别序列
Payroll Group Search=搜寻支薪组别
Payroll History Enquiry/Adjustment=过往支薪纪录查询及调整
Payroll History Detail Report=过往支薪详情报告
Payroll History Summary Report=过往支薪摘要报告
Payroll Period=支薪期
Payroll Period From=支薪期由
Payroll Process End=结束支薪程序
Payroll Trial Run=支薪试算
Payroll Trial Run Adjustment=调整支薪试算
Payroll Trial Run Detail=支薪试算详情
Payroll Trial Run Detail Report=支薪试算详情报告
Payroll Trial Run Employee List=支薪试算雇员列
Payroll Trial Run Information=支薪试算资料
Payroll Trial Run Summary Report=支薪试算摘要报告
Pension=职业供款计划
Period=周期
Period of employment=雇用期间
Personnel=人事
P-Fund Detail=公积金详情
P-Fund Report=公积金报告
P-Fund Statement=公积金结算单
Phone=电话
Place Of Birth=出生地点
Plan Code=计划代号
please specify=请注明
Position=职位
Position History=过往职位纪录
Previous=上一个
probable date of return is=返港的大概日期为
Probation Last Date=试用最后日期
Probation Period=试用期
Process End=结束支薪程序
Process Month=处理月份
Product Code=产品代号
Profile=资料
Qualifications=学历
R.I.=有关入息
Rank=阶级
Ranks=阶级
Read=读取
Read/Write=读取/写入
Reason for Cessation=停止受雇原因
Reason for departure=离港原因
Record=记录
Records=记录
Recurring Payment=定期支薪
Recurring Payment History=过往定期支薪记录
Reference Date=参考日期
Relationship=关系
Remark=备注
Rent Paid to Employer By Employee=由雇员付给雇主的租金
Rent Paid to Landlord by Employee=由雇员付给业主的租金
Rent Paid to Landlord by Employer=由雇主付给业主的租金
Rent Refunded To Employee=由雇主发还给雇员的租金
Report=报告
Reports=报告
Residential Address=住址
Resign Date=辞职日期
Resignation Date=辞职日期
Rollback=还原
Rollback Payroll Trial Run=还原支薪试算
Scheme No=计划号码
Scheme Number=计划号码
Security=保安
Service Start Date=服务日期
Severance Pay=遣散费
Sex=性别
Skill=技能
Skill Level=技能级别
Skills=技能
Spouse=配偶
Spouse HKID=配偶的香港身份证号码
Spouse Name=配偶的姓名
Spouse Passport Country Issued=配偶的护照发证国家
Spouse Passport No=配偶的护照号码
Staff Type=职员种类
Standard Chartered Bank File Detail=渣打银行自动转账档案
Start=开始
Start Contribute on Date of Join=供款由入职开始
Start Date of Service=服务开始日期
Status=状况
Statutory Holiday Setup=法定假期设定
Statutory Holiday Allowance Formula=法定假期津贴公式
Statutory Holiday Deduction Formula=法定假期扣减公式
Statutory Holiday Payment Eligible After=法定假期的款项生效于
Statutory Holiday Year=法定假期年份
Surname=姓氏
System=系统
System Default=系统默认
System Defined=系统默认
Taken=已取
Tax File No.=税务局档案号码
Taxation=税务
Taxation Adjustment=税务调整
Taxation Category Mapping=税务种类配对
Taxation Company=税务公司
Taxation Company Setup=税务公司设定
Taxation Company Details=税务公司详情
Taxation Company Information=税务公司资料
Taxation Company List=税务公司序列
Taxation Company Search=搜寻税务公司
Taxation Diskette Generation=制作税务磁盘
Taxation Form Type=税务表格类别
Generate Taxation Records=制作税务记录
Taxation Header=税务上款资料
Taxation Info=税务资料
Taxation Information=税务资料
Taxation Payment Detail=税务支薪详情
Taxation Payment Type=税务支薪类别
Taxation Report=税务报告
Terminated Employee=离职雇员
Termination=终止雇用
Termination Details=终止雇用详情
Termination Reason=离职原因
The employee's Salaries Tax borne by employer=雇员的薪俸税是否由雇主支付
The following employee has not been confirmed=以下的雇员尚未完成支薪确定
The following employee has not been run=以下的雇员尚未完成支薪试算
the reason is=原因是
This amount must also be included in item 11=此款额必须包括在第11 项内
Time=时间
To=至
Total=总计
Transfer Company?=是否调职
Trial Run=试算
Trial Run Detail=试算详情
Trustee=信托人
Trustee Name=信托人名称
Type=类别
Unit=单位
Upload file path=上载档案路径
Use residual for employee=与雇员强积金对冲
Use residual for employer=与雇主强积金对冲
User=用户
User Group Setup=用户组别设定
User Group List=用户组别序列
User Group Search=搜寻用户组别
User Groups=用户组别
User ID=用户编号
User Info=用户数据
User List=用户序列
User Maintenance=用户设定
User Name=用户名称
User Search=搜寻用户
Value=数值
Value Date=过账日
VCEE=雇员自愿性供款
VCER=雇主自愿性供款
View Accommodation=检视住处
View AVC Plan=检视自愿性供款计划
View Bank Account=检视银行户口
View Business Hierarchy=检视商业层级
View Company=公司检视
View Contract Terms=检视合约条款
View Dependant=检视家属
View Employee Profile=检视雇员资料
View Employee Skills=检视雇员技能
View Final Payments=检视最后工资
View Leave Adjustment=检视休假调整
View Leave Application=检视休假申请
View Leave Code=检视休假代号
View Leave Plan=检视休假计划
View Leave Plan Entitlement=检视休假计划的应得权利
View Leave Type=检视休假类别
View MPF Plan=检视强积金计划
View ORSO Plan=检视职业退休计划
View P-Fund Plan=检视公积金计划
View Payment Code=检视支薪代号
View Payroll Formula=检视支薪公式
View Payroll Group=检视支薪组别
View Position Information=检视职位资料
View Qualification=检视学历
View Recurring Payment=检视定期支薪
View Spouse=检视配偶资料
View Taxation Adjustment=检视
View Taxation Company=检视
View User=检视
View User Group=检视
Whether the employee has any share options granted by your company or any other corporation in respect of his employment with/office in your company that are not yet exercised, assigned or released=雇员/董事是否持有你或其他公司就其受雇而发给但未行使、转让或放弃的股份认购权
Whether the employee has been conditionally granted a share options prior to commencing to be employed in Hong Kong, which can be exercised after rendering services in Hong Kong=雇员是否在受雇于香港工作前，已获有条件地授予股份认购权，规定他要在香港提了服务后才可行使这些认购权
Oversea concern yes no=雇员的全部或部分入息是否由海外公司在本港或海外支付
Whether the employee would return to Hong Kong=雇员会否回港
Year=年份
Year of Service less than=服务年资 &lt;
Year Return=年度
- Back -=返回
New=新增
Save=储存
Delete=删除
Search=搜寻
Reset=重设
Help=说明
Add=新增
Cancel=取消
Go=执行
Re-Calculate=重新计算
Terminate=离职
Generate Final Payment=制作最后工资
Undo=还原
Display=显示
Process=处理
Generate Bank File=制作银行档案
Generate Bank File with Autopay List=制作银行档案及自动转账列表
Generate Autopay List=制作自动转账列表
Generate Autopay List (Excel)=制作自动转账列表 (Excel)
Generate=制作
- Payment Detail -=支薪详情
- Place of Residence Detail -=住处详情
Generate File=制作档案
Generate Control List=制作纪录核对表
Generate Report=制作报告
Print=打印
ACTIVE_STAFF=在职
Terminated=已离职
Hourly=每小时
Daily=每日
Once per payroll cycle=每支薪期一次
Month=月
Hong Kong=香港
Kowloon=九龙
New Territories=新界
Overseas=海外
Male=男
Female=女
Single=单身
Widowed=丧偶
Divorced=离婚
Separated=分居
Married=已婚
Autopay=自动转账
Cash=现金
Cheque=支票
Other=其他
Yes=是
No=否
brother=兄弟
brother-in-law=姊妹的丈夫
daughter=女儿
father=父亲
father-in-law=岳父
friend=朋友
mother=母亲
mother-in-law=岳母
other relative=其他亲戚
sister=姐妹
sister-in-law=夫或妻的姊妹
son=儿子
January=一月
February=二月
March=三月
April=四月
May=五月
June=六月
July=七月
August=八月
September=九月
October=十月
November=十一月
December=十二月
Single/Widowed/Divorced/Separated=单身/丧偶/离婚/分居
Expatriate staff return to home country=海外职员返回袓国
Secondment=暂借
Emigration=移民
Reset Balance=重设结余
Adjustment=调整
Update Terms=更新条款
Update=更新
Insert=插入
ERROR_DATE_FROM_OVERLAP=开始日不能重迭
ERROR_ACCOUNT_REQUIRED=必须输入户口号码
ERROR_DATE_TO_TOO_EARLY=终结日不能早于开始日
ERROR_TERMINATION_RECORD_NOT_FOUND=找不到离职数据
ERROR_EMP_NOT_TRANSFERABLE=不能转移此雇员
ERROR_EMP_TRANSFERRED_BEFORE=雇员已曾经转移(编号: {0})
ERROR_CODE_USED_BY_EMPLOYEE={0} '{1}' 正被以下雇员使用
ERROR_CODE_IS_IN_USE={0} 正在使用中
ERROR_CODE_DUPLICATE=重复的{0}. '{1}' 已经存在
ERROR_LEAVE_APP_OVERLAP=休假日不能跟以前的休假申请重迭
ERROR_POS_OVERLAP=生效日期不能与之前的生效日期重迭
ERROR_DAYS_TOO_LARGE=申请日数过大
ERROR_INVALID_HOUR=时间不正确
ERROR_LEAVE_APP_NOT_SAME_MTH=休假申请必须在同一个月内
ERROR_INCORRECT_PASSWORD=密码不正确
ERROR_CONFIRM_PASSWORD=确认密码与密码不同
ERROR_INVALID_DOB=出生日期不正确
ERROR_ONE_PAYMENT_PER_PCODE=支薪代号不能重复使用
ERROR_LEAVE_ADJ_OVERLAP=修正的日期与之前的休假调整重迭
ERROR_PAY_EFF_DATE_OVERLAP=当支薪代号重复使用时生效日期不能重迭
ERROR_DUPLICATE_YEAR_SERVICE=年资已存在
ERROR_DIVIDER_NOT_ZERO=份母不能为零
ERROR_INVALID_START_DATE=开始日不正确
ERROR_INVALID_END_DATE=终结日不正确
ERROR_INVALID_PERIOD=开始日/终结日不正确
ERROR_REC_CND_NOT_SELECT=请选择定期支薪或索偿与扣减
ERROR_EMP_TYPE_NOT_SELECT=请选择最少一个雇员种类
ERROR_INCORRECT_DATE_RANGE=日期范围错误
ERROR_DATE_END_TOO_EARLY=终结日不能早于开始日
ERROR_PASSWORD_NOT_MATCH=密码不相乎
Personal Information=个人资料
Spouse/Dependant=配偶/家属
Qualification/Skills=学历/技能
Current Status=现况
Pension History=职业供款计划纪录
Leave Applications & History=休假申请及纪录
Employer Participation No.=雇主参与编号
% of Contribution=供款百分比
Occupational Retirement Schemes Ordinance=职业退休计划
Taxation Place of Residence Detail=税务住处详情
Forfeiture=丧失
Entitled=应得
Reserved=预订
Leave Balance Adjustment=休假结余调整
ERROR_DELETE_EMP_PAYMENT_EXISTS=员工编号 {0} 已经有支薪. 拒绝删除
PARAM_CODE_LOGIN_MAX_FAIL_COUNT=封锁账号失败次数
PARAM_CODE_LEAVE_ENTITLE_CUT_OFF_BY_SERVICE_DATE=用服务开始日子的月/日为结算日
PARAM_CODE_LEAVE_ENTITLE_CUT_OFF_MONTH=默认结算月份
PARAM_CODE_LEAVE_ENTITLE_CUT_OFF_DAY=默认结算日
PARAM_CODE_USE_ORSO=允许使用公积金计划(例如: 职业退休计划)
PARAM_CODE_TAXATION_USE_CHINESE_NAME=提交中文姓名到税务处(不建议)
PARAM_CODE_SMTP_SERVER_NAME=外送邮件传送(SMTP)服务器名称
PARAM_CODE_SMTP_PORT=端口
Username=用户名称
LOGIN_MAIN_MESSAGE=请输入用户名称及密码
Payment Summary List=付款摘要列表
Rounding Rule=进位规则
Rollback Payroll Process=还原支薪程序
System Parameters Setup=系统参数设定
ERROR_ACTION_ABORT=动作终止!
SYSTEM_APP_VERSION=系统版本
SYSTEM_DB_VERSION=系统数据库版本
RUNNING_DB_VERSION=正在执行中的数据库版本
Year End Bonus Plan Setup=年终奖金计划设定
Code Setup=代号设定
Introduction=序言
MPF Setup=强积金设定
Logout=注销
System Requirements=系统需求 
System Requirement=系统需求 
Generate MPF File=制作强积金档案
Hide in Pay Slip=不显示于支薪通知书
Year End Bonus Plan Search=搜寻年终奖金计划
Year End Bonus Plan List=年终奖金计划序列
Eligible After Probation=通过试用期适用
Position Capacity=职位 (于税务表格显示)
Age=年龄
YEB Plan=年终奖金计划
Class Name=级别名称
Adjust Type=调整类别
Year End Bonus Options=年终奖金计划选项
Import=导入
Import Claims and Deductions=导入索偿与扣减
Import Details=上载详情
Upload=上载
Claims and Deduction=索偿与扣减
Bank File Information=银行档案资料
HSBC MPF File Detail=香港汇丰银行强积金档案详情
Payment Method=付款方式
Employer ID=雇主编号
Default Class Name=预设级别名称
Login=登入
Cost Allocation=成本分配
CostCenter=成本中心
Cost Center Setup=成本中心设定
Cost Allocation Trial Run=成本分配试算
Cost Allocation Trial Run Adjustment=调整成本分配试算
Cost Allocation Confirmation=成本分配确认
Cost Allocation Export to Excel=成本分配电子表格导出
Round to=进位至
Round up=上舍入
Round down=下舍入
decimal place(s)=小数位
Monthly Average Wages=每月平均工资
First Authorization Group=第一批核组别
Second Authorization Group=第二批核组别
Eligible Period=适合周期
Pass code for rollback process=还原支薪程序密码
Rollback to previous payroll cycle=还原至上一支薪周期
DELETE_GENERIC_JAVASCRIPT=删除的项目不可能复原。\r\n确认删除吗?
ERROR_MPF_DATE_TO_TOO_EARLY=生效日期不能早于 2000-12-01.
ERROR_LEAVE_ALLOWANCE_SHOULD_BE_WAGES=假期津贴应该是薪酬
ERROR_LEAVE_ALLOWANCE_SHOULD_NOT_BE_WAGES=假期津贴不应该是薪酬
Attendance=考勤
Roster Code Setup=当值时间代号设定
Roster Code Search=当值时间代号搜寻
Roster Code List=当值时间代号列序
Roster Code=当值时间代号
Roster Type=当值时间种类
Work Time Period Setting=工作时间周期设定
Count Total Work Hour Only=总工作小时
In Time=上班时间
Out Time=下班时间
Grace In Time=上班时间宽限
Grace Out Time=下班时间宽限
Enable Meal Break=启用用膳时间设定
Overtime Setting=超时工作设定
Enable Overtime=启用超时工作设定
Miscellaneous=杂项
Cut Off time=截数时间
Working Day Unit=工作日单位
Daily Working Hour=每日工作小时
Attendance Formula Setup=考勤公式设定
Attendance Formula Search=考勤公式搜寻
Attendance Formula List=考勤公式序列 
Attendance Formula=考勤公式
Attendance Plan Setup=考勤计划设定
Attendance Plan Search=考勤计划搜寻
Attendance Plan List=考勤计划序列 
Attendance Plan=考勤计划
mins=分钟
Overtime=超时工作
Overtime Formula=超时工作公式
Late=迟到
Late Formula=迟到公式
Bonus Condition=考勤奖金条件
Max Late Count=最多迟到次数
Max Early Leave Count=最多早退次数
Max Sick Leave taken with Medical Certifcate=最多有医生证明病假次数
Max No Pay Leave=最多无薪假次数
Max Absent=最多缺席次数
Bonus Amount=奖金
Max Late (mins)=最多迟到(分钟)
Max Early Leave (mins)=最多早退(分钟)
Max Sick Leave taken without Medical Certifcate=最多没有医生证明病假次数
Max Injury Leave Taken=最多任务伤休假次数
Display Sequence No.=显示次序
Time Card No.=考勤卡号码
For Employee Self Service=雇员自助服务专用
Company E-mail Address=公司电邮地址
Cost Center=成本中心
Rounding Rule for Employer Contribution=雇主供款进位规则
Rounding Rule for Employee Contribution=雇员供款进位规则
Cost Allocation Detail Export=导出成本分配详情
Confirmed=已确认
Year/Month=年/月
Export=导出
Cost Allocation Summary Export=导出成本分配摘要
Export Roster Table=导出当值时间表
Import Roster Table=导入当值时间表
Import Time Card Records=导入拍卡纪录
ColumnDelimiter=字段定义符号
(Space)=(空格)
Field Column=字段
Location=地点
Sequence=次序
Year Format=年份格式
Date Separator=日期分隔符
Time Separator=时间分隔符
Import Time Card Record=导入拍卡纪录
Generate Attendance Record=制作考勤纪录
Attendance Record Adjustment=调整考勤纪录
Roster=当值时间
Work Start=开始工作时间
Meal Break Out=用膳外出时间
Meal Break In=用膳返回时间
Work End=结束工作时间
Late (mins)=迟到(分钟)
Attendance Record Detail=考勤纪录详情
Early Leave (mins)=早退(分钟)
Overtime (mins)=超时工作(分钟)
Working Day(s)=工作日数
Working Hour(s)=工作小时
Absent=缺勤
Export Attendance Record=导出考勤纪录
Export Attendance Records=导出考勤纪录
Import Attendance Record=导入考勤纪录
Import Attendance Records=导入考勤纪录
Generate Attendance Payment=制作考勤工资
Audit Trail=审计追踪
ESS Authorizer Setup=雇员自助服务批核人设定
Authorization Group Setup=批核组别设定
Assign Authorizer=批核人指定
Edit Year End Bonus Plan=编辑年终奖金计划
Globally applied to all employee=应用于所有雇员
Reset Password=重设密码
Contract No=合约号码
For Payroll Calculation Only=支薪计算专用
Override Employer=不理会雇主计划设定
Override Employee=不理会雇员计划设定
Cost Center Code=成本中心代号
View Cost Center=检视成本中心
Follow pre-defined payment method=请选择以下方式支付
Default autopay bank account=预设自动转账户口
Final Payment Options=最后工资选项
Daily Formula for AL Compensation=每日有薪年假补偿公式
Payment Code for AL Compensation by Employer=有薪年假雇主补偿支薪代号
Monthly payment formula for Payment In Lieu=代通知金公式 通知期以月为单位
Daily payment formula for Payment In Lieu=代通知金公式 通知期以日为单位
Payment Code for Payment In Lieu (Employer)=雇主代通知金支薪代号
Payment Code for Payment In Lieu (Employee)=雇员代通知金支薪代号
Monthly payment formula for Long Service Payment / Severance Payment=月薪雇员长期服务金/ 遣散费公式
Payment code for Long Service Payment=长期服务金支薪代号
Payment code for Severance Payment=遣散费支薪代号
Export Template=导出范本
Days Adjust=日数调整
No. of days count=已计算日数
Employee Salary List=雇员工资列表
Employee Bank Account List=雇员银行户口列表
Payroll Detail Report=支薪详情报告
Payroll Summary Report=支薪摘要报告
System Information=系统数据
Test Email Function =电邮测试
Email Address=电邮地址
Send=传送
Confirm Cost Allocation=确认成本分配
Field=字段
Column=栏
Authorization Group=批核组别
Authorizer Setup=批核人设定
Authorization Group Code=批核组别代号
Authorizer List=批核人列序
EE Info=雇员资料
Leave Application=休假申请
Receive Other Group Alert=接收其他组别通知
INBOX_SUBJECT_DOB18=18岁提示 ({0} - {1})
INBOX_SUBJECT_DOB65=65岁提示 ({0} - {1})
INBOX_SUBJECT_DOB=生日提示 ({0} - {1})
PARAM_CODE_PAY_SLIP_HIDE_LEAVE_BALANCE=在支薪通知书中隐藏休假结余
ERROR_INVALID_FILE=档案不正确或没有选择任何档案
Active=生效中
Inactive/Locked=无效/已锁
Extra Information=额外数据
Work Permit/License=工作证/牌照
Document=文件
Permit Type=许可证类别
Document Type=文件类型
PARAM_CODE_PAYROLL_MAX_MONTHLY_LSPSP_AMOUNT=计算长期服务金/遣散费最大每月工资
PARAM_CODE_PAYROLL_MAX_TOTAL_LSPSP_AMOUNT=最大可获得长期服务金/遣散费
UNIFORM_B=上围/胸围
UNIFORM_W=腰围
UNIFORM_H=下围/臀围
Tools=工具
Inbox=收件匣
User Preference=用户喜好设定
Private Message=私人信息
Inbox Message List=收件匣信息列表
Subject=主旨
Reminder=提示
Reminder Type=提示种类
Birthday Reminder=生日提示
Age of 18 Birthday Reminder=18岁生日提示
Age of 65 Birthday Reminder=65岁生日提示
Criteria=准则
Function=工能
Roster Client Setup=当值客户设定
Roster Client Search=当值客户搜寻
Roster Client List=当值客户列序 
Export Employee Information=导出雇员资料
INBOX_SUBJECT_PROBATION=试用期提示 ({0} - {1})
INBOX_SUBJECT_TERMINATION=离职提示 ({0} - {1})
INBOX_SUBJECT_WORKPERMITEXPIRY=工作证到期提示 ({0} - {1})
UNREAD_MESSAGE_POPUP_MESSAGE=你有 {0} 个未读讯息
NEW_MESSAGE_POPUP_MESSAGE=你有 {0} 个新讯息
MPF Termination Code Setup=强积金离职代号设定
MPF Termination Code Mapping=强积金离职代号配对
MPF Termination Code Search=强积金离职代号搜寻
MPF Cessation Reason List=强积金离职原因列序
MPF Scheme=强积金计划
YEB Prorata=年终奖金按比例计算
ERROR_PASSWORD_SAME_AS_OLD_PASSWORD=新密码不能与旧密码相同
PARAM_CODE_DEFAULT_LANGUAGE=系统默认语言
PARAM_CODE_ESS_DEFAULT_LANGUAGE=员工自助服务系统默认语言
View Year End Bonus Plan=检视奖金计划设定
Prorata Method=按比例计算方式
Monthly=每月
Uniform Information=制服资料
View Work Permit/License=检视工作证/牌照 
Edit Work Permit/License=编辑工作证/牌照 
Permit No.=许可证号码
Issue Date=发出日期
Expiry=有效日期
Working Experience=工作经验
Document List=文件序列 
Default Roster Code=预设当值时间代号
Default MPF Plan=预设强积金计划
Percent=百分比
Edit Cost Center=编辑成本中心
Relevant Certificate=相关证明
Hour=时
Leave Code List=休假代号序列
Max. Brought Forward=最大带假日数
Cessation Reason List=离职原因序列
Default Value=预设数值
Outgoing Email Address=外送电邮地址
SMTP Server=外送邮件传送服务器
Language=语言
Probation Reminder=试用期提示
Employee Termination Reminder=雇员离职提示
Work Permit Expiry Reminder=工作证到期日提示
Cost Allocation Adjustment=调整成本分配
Cost Allocation Detail=成本分配详情
Roster Client=当值客户
Roster Client Site=当值客户地点
Property Name=物业名称
Nature of Premises=物业性质
In Charge=负责人
Contact No=联络号码
Service Hours=服务日间
Shift=轮班
Client Name=客户名称
Site=地点
Meal Break Start Time=用膳开始时间
Meal Break End Time=用膳结束时间
OT Start Time=超时工作开始时间
OT End Time=超时工作结束时间
Count OT from Out Time=由离开时间开始计算超时工作
OT Unit=超时工作计算单位
Override Hourly Rate=不理会预设时薪
New Hourly Rate=新的时薪
Deduct Working Hour for Meal Break=扣减用膳时间
Overtime Ratio=超时工作比率
No Of Hour=小时
Rate=比率
View Roster Code=检视当值时间代号
View Attendance Formula=检视考勤公式
Formula for Daily Prorata=计算日薪公式
Formula for Hourly prorata=计算时薪公式
Use Payroll Formula=采用支薪公式
Fix Hourly Rate=固定时薪
Work hour per day=每日工作时数
Daily Payment/ Work hour per day=日薪/ 每日工作时数
per hour=每小时
Include Early Leave=包括早退
Max Sick Leave taken with Relevant Certificate=最多病假次数(有相关证明)
Max Sick Leave taken without Relevant Certificate=最多病假次数(没有相关证明)
Recalculate=重新计算
Has Bonus=有奖金
By Attendance Plan=根据考勤计划
Employee Salary Report=雇员工资列表
Employee Year of Service List=雇员服务年资列表
Employee Year of Service Report=雇员服务年资列表
Employee Bank Account Report=雇员银行户口列表
Parameter=参数
Not Selected=未选择
Confirmed Date =确认日期
Confirmed By =确认用户
Edit Working Experience=编辑工作经验
View Working Experiencet=检视工作经验
Switch Display Mode=切换显示模式
Payroll Process Cycle=支薪处理周期
Edit Document=编辑文件
View Document=检视文件
File name=文件名
Emergency Contact=紧急联络数据
View EmergencyContact=检视紧急联络数据
Edit EmergencyContact=编辑紧急联络数据
Phone No. (Day)=联络号码 (日间)
Phone No. (Night)=联络号码 (夜间)
Retrive data from last information=读取旧数据
Export to Excel=汇出成Excel文件
Export to Word=汇出成Word文件
FUNCTION_SYS000=系统参数设定
FUNCTION_SYS001=公司设定
FUNCTION_SYS002=公司架构设定
FUNCTION_SYS003=商业层级设定
FUNCTION_SYS004=支薪代号设定
FUNCTION_SYS005=杂项代号设定
FUNCTION_SYS006=假期设定
FUNCTION_SYS007=年终奖金计划设定
FUNCTION_SYS008=审计追踪
FUNCTION_SYS009=工作时间组合设定
FUNCTION_SYS999=审计追踪
FUNCTION_SEC001=用户设定
FUNCTION_SEC002=用户组别设定
FUNCTION_SEC003=批核组别设定
FUNCTION_SEC004=批核人设定
FUNCTION_PER001=雇员个人资料
FUNCTION_PER002=雇员银行户口资料
FUNCTION_PER003=雇员配偶/家属资料
FUNCTION_PER004=雇员学历/技能
FUNCTION_PER005=雇员住处资料
FUNCTION_PER006=雇员合约资料
FUNCTION_PER007=雇员职位纪录
FUNCTION_PER007-1=雇员定期支薪记录
FUNCTION_PER008=雇员职业供款计划纪录
FUNCTION_PER009=雇员休假申请及查询休假纪录
FUNCTION_PER010=雇员休假结余
FUNCTION_PER011=雇员终止雇用
FUNCTION_PER012=雇员成本中心
FUNCTION_PER013=雇员工作证/牌照资料
FUNCTION_PER014=雇员文件数据
FUNCTION_PER015=雇员紧急联络数据
FUNCTION_PER016=雇员工作经验
FUNCTION_PER017=雇员工伤记录
FUNCTION_PER018=雇员获取补假记录
FUNCTION_PER019=雇员编更表组别
FUNCTION_PER900=导出雇员资料
FUNCTION_LEV001=休假类别设定
FUNCTION_LEV002=休假代号设定
FUNCTION_LEV003=休假计划设定
FUNCTION_PAY001=支薪组别设定
FUNCTION_PAY002=支薪公式设定
FUNCTION_PAY003=索偿与扣减
FUNCTION_PAY004=支薪试算
FUNCTION_PAY005=调整支薪试算
FUNCTION_PAY006=还原支薪试算
FUNCTION_PAY007=支薪确认
FUNCTION_PAY008=结束支薪程序
FUNCTION_PAY009=过往支薪纪录查询及调整
FUNCTION_PAY010=制作银行档案
FUNCTION_PAY011=制作强积金档案
FUNCTION_PAY900=还原支薪程序
FUNCTION_MPF001=强积金计划设定
FUNCTION_MPF002=强积金参数设定
FUNCTION_MPF003=自愿性供款计划设定
FUNCTION_MPF004=公积金计划设定
FUNCTION_MPF005=强积金离职代号设定
FUNCTION_CST001=成本分配试算
FUNCTION_CST002=调整成本分配试算
FUNCTION_CST003=确认成本分配
FUNCTION_CST004=导出成本分配详情
FUNCTION_CST005=导出成本分配摘要
FUNCTION_ATT001=当值时间代号设定
FUNCTION_ATT002=考勤公式设定
FUNCTION_ATT003=考勤计划设定
FUNCTION_ATT004=导出当值时间表
FUNCTION_ATT005=导入当值时间表
FUNCTION_ATT006=导入拍卡纪录
FUNCTION_ATT007=制作考勤纪录
FUNCTION_ATT008=调整考勤纪录
FUNCTION_ATT009=导出考勤纪录
FUNCTION_ATT010=导入考勤纪录
FUNCTION_ATT011=制作考勤工资
FUNCTION_ATT012=当值客户设定
FUNCTION_TAX001=税务公司设定
FUNCTION_TAX002=税务种类配对
FUNCTION_TAX003=制作税务记录
FUNCTION_TAX004=税务调整
FUNCTION_TAX005=制作税务磁盘
FUNCTION_RPT001=雇员报告
FUNCTION_RPT002=支薪及强积金报告
FUNCTION_RPT003=税务报告
ERROR_HKID_PASSPORT_REQUIRED=必需输入香港身分证号码或护照号码
ERROR_HKID_PASSPORTCOUNTRY_REQUIRED=必需输入香港身分证号码或护照号码连发证国家
ERROR_INVALID_VALUE_DATE=过账日不正确
ERROR_TOTAL_PERCENTAGE_NOT_100=总百分比必须要100%
ERROR_LEAVE_APP_TIME_OVERLAP=休假时间不能跟以前的休假申请重迭
Re-join=重新入职
REJOIN_TERMINATED_EE_JAVASCRIPT="重新入职" 动作会删除所有离职数据, 但会保留已支付的最后工资数据.\r\n还要继续吗?
ERROR_NUMBR_RANGE=数字必需在 {0} 和 {1} 之间
MAX_COMPANY=最多可用公司数目
MAX_USERS=最多可用用家数目
TRIAL_PERIOD_TO=测试版本限期至
ENTER_AUTHORIZATION_CODE=输入验证码
EELEAVEAPP=假期申请
EEPROFILE=个人资料
EELEAVECANCEL=取消假期申请
EEOTCLAIM=补假申请
EEOTCLAIMCANCEL=取消补假申请
USRSUBMIT=已递交
USRCANCEL=取消申请
1STAPPROVED=初步申请认可
APPROVED=申请认可
1STREJECTED=第一批核者拒绝
2NDREJECTED=第二批核者拒绝
Show Advanced Options=显示进阶选项
Hide Advanced Options=隐藏进阶选项
Training=训练
Training Record=训练记录
Training Seminar Setup=训练课程设定
Training Report=训练报表
Training Seminar Search=训练课程搜寻
Training Seminar Detail=训练课程资料
Training Seminar List=训练课程列表
Training Course=训练科目
Trainer=导师
Training Date=训练日期
Duration=需要时间
View Training Seminar=检视训练课程
Edit Training Seminar=编辑训练课程
Enroll Training Seminar=登记训练课程
Enroll=登记
Remove=移除
PARAM_CODE_DEFAULT_RECORDS_PER_PAGE=每页显示记录
PARAM_CODE_MPF_FILE_BOCI_ENCRYPT_PATH=中银保诚加密程序的完整路径
PARAM_CODE_DOCUMENT_UPLOAD_FOLDER=上载文件的完整路径
PARAM_CODE_DB_TITLE=数据库标题 (用作识别数据库，例如：UAT)
Emp. No.=雇员编号
Emp. Name=雇员名称
Mobile=手提电话号码
Email=私人电邮地址
Residential Addr=住址
Correspondence Addr=通讯地址
Is Wages:=是否工资:
Phone No (Day)=联络电话(日间)
Phone No (Night)=联络电话(夜间)
Upload File=上载档案
Date of Join=入职日期
Employee ID=雇员编号
Job Position=职位
Date Join=入职日期
Date Left=最后工作日期
Year of Service=服务年资
Year of Service List=雇员服务年资列表
As of=直至
Bank Name=银行名称
A/C No=户口号码
Employee Detail Report=雇员详情报告
Basic Information=基本数据
As Of Date (Current)=现在日期 (现在)
Reference Date (Previous)=参考日期 (上一个) 
Hierarchy=层级
New Join=新入职
Transfer In=转入
Transfer Out=转出
Turnover=员工流动
Employee Gender Report=雇员性别报告
Employee Residency Report=雇员住处报告
Employee Birthday List=雇员生日列表
Employee Leave Application List=雇员休假申请列表
Leave Balance List=休假结余列表
Employee ESS Request Report=雇员自助服务未批核申请报告
Net Payment Report by Payment Method=净薪金报告(以付款方式列出)
Payment Allocation Report=薪金配置报告
Employee No.=雇员编号
Emp Name=雇员名称
Business Group=商业组别
Termination Code=离职原因
Employe Name=雇员名称
Days=日数
Relevant Certificate?=相关证明?
Entitlement=应得
Emp No:=雇员编号:
Name:=雇员名称:
Applications=申请
No. of Day(s) Taken=已取日数
Entitle=应得
Submit Date/Time=递交日期/时间
Submit Type=递交类别
Recurring Payments=定期支薪记录 
Bank Accounts=银行户口 
Account No.=户口号码
Bank Account Name=户口持有人
Issues by:=签发国家
ESS Authorization Group Setup=雇员自助服务批核组别设定
Annual Leave Prorata Rounding Rule Setup=年假按比例计算进位规则设定
Annual Leave Prorata Rounding Rule Search=搜寻年假按比例计算进位规则
Rounding Rule List=进位规则列表
View Annual Leave Prorata Rounding Rule=检视年假按比例计算进位规则
Annual Leave Prorata Rounding Rule=年假按比例计算进位规则
Calculate Statutory Holiday on next month=于下一个月计算法定假期
Statutory Holiday Options=法定假期选项
Compare previous leave plan enrolled=比较以前休假计划
Do not include Feb 29 when calculating prorata=不要将2月29日加入按比例计算
Reset Year of Service When Changed Employee Leave Plan=当雇员转换休假计划重新计算服务年资
Do not count first incomplete year of service=不要计算第一年不完整服务年资
Leave Plan Rank Level=休假计划等级
The setting "Compare previous leave plan enrolled" is required=需与"比较以前休假计划"一并使用
Use Business Internet Banking Service (max. 200 transaction per file)=使用商务网上理财 (每个档案最多包含200个交易)
Payment Code for multiple bank file=输入支薪代号以制作多个银行档案
(press ENTER to separate each payment code=(按ENTER以分隔不同支薪代号)
Previous Value Date=过账日
Others=其他
Emp No.=雇员编号
End Of Report=报告结束
Birthday Range=生日范围
Display Year of Birth=显示出生年份
HK ID=香港身份证号码
Remarks=备注
Issued By=签发国家
Difference=相差
Process Month/Year=处理月份/年份
Reference Month/Year=参考月份/年份
Reference Month=参考月份
Specified Date=指定日期
Wages From=工资开始日
Wages To=工资结束日
Total Wages=工资总额
Total OT Income=超时工资总收入
Total Exclude Wages=不予计算工资
Include OT Income?=包含超时工资
Total Work Days=总工作日数
Total Days Exclude=不予计算日数
Daily Average Wages=每日平均工资
Report Period=报告期
Payment code description=支薪代号描述
MPF Contribution Detail=强积金供款详情
Relevant Income=有关入息
Mandatory Contribution=强积金供款
Voluntary Contribution=自愿性供款
Total Contribution=供款总额
MPF Date=强积金日期
Chinese=中文姓名
Emp.Seq=雇员编号
Emp.Name=雇员名称
Contribution=供款
Net Income=净收入
Net Payments Group by Pay Method=净收入以支薪方式分类
Payroll History Information=过往支薪纪录
Country of Issue=签发国家
ESS Pending Request Report=雇员自助服务未批核申请报告
ERROR_CND_IMPORT_BATCH_PAYROLL_PROCESSING=由于以下员工正在执行支薪程序, 还原汇入失败 :
ERROR_NO_RECORD_IMPORT=没有纪录可以汇入
ERROR_SUPER_USER_REQUIRED=系统最少要有一个用户可以存取 用户组别设定 或 用户设定.
Import History=过往导入纪录
Outstanding Records=待处理纪录
History Records=过往纪录
Companies=公司
Calculate Working Hours/Days by half if total working hours is smaller than=将工作时数/日数减半, 如工作时数小于
Injury Record=工伤纪录
Accident Date=意外发生日期
Injury Nature=损伤性质
Date of Accident=意外发生日期
Nature of Injury=损伤性质
Location of Accident=意外发生地点
Reason for Accident=意外发生的原因
Date of Report=报工伤日期
Cheque Received Date=收票日期
Settle Date=完结日期
Bonus Amount for Overtime (per hour)=超时工作奖金(每小时)
Overtime start at=超时工作在正常工作时间完结后
min(s) after the end of normal working hours=分钟开绐
Total Income=总收入
Pay Slip=支薪通知书
No. of Records:=纪录数目:
Group by Hierarchy Level :=以公司架构分类:
Provident Fund Statement=公积金报告
Contribution Period=供款期
ERROR_DATE_TOO_EARLY=日期不能早过入职日期
ERROR_DATE_TOO_LATE=日期不能迟过最后工作日期
LEAVEAPP_FORCE_DELETE_JAVASCRIPT=假期申请已经用作支薪计算\r\n你必须手动调整支薪纪录\r\n你确定要删除吗? 
LEAVEAPP_FORCE_EDIT_JAVASCRIPT=假期申请已经用作支薪计算\r\n你必须手动调整支薪纪录\r\n你确定要储存吗?
Check E-mail Log =查阅电邮记录
Updated Successful=更新成功
Public Holiday Setup=公众假期设定
Public Holiday Year=公众假期年份
Update Holiday Table by File=以导入档案更新假期表
Set Paid Date=支付日期纪录
Set paid date to=设定支付日期至
Paid Date=支付日期
Force Edit=强行更改
Force Delete=强行删除
PARAM_CODE_PAY_SLIP_HIDE_MINIMUM_WAGE_INFO=在支薪通知书中隐藏最低工资的信息
Do not deduct Voluntary contribution being contributed to mandatory contribution=如已供强积金供款, 该部份不要计算自愿性供款
The setting "Do not deduct MPF Only payment being contribute" under AVC Plan Setting is required=The setting "Do not deduct MPF Only payment being contribute" under AVC Plan Setting is required
Ceiling Amount=最大限额
Contributed after MPF Only=Contributed after MPF Only
Payment Setting=供款设定
Work Hour Pattern Setup=工作时间模式设定
Work Hour Pattern Search=工作时间模式搜寻
Work Hour Pattern List=工作时间模式序列
Working hour determine method=计算工作时数方法
Default Working hour per day=预设每日工作时数
Default meal break hour per day=预设每日用膳时间
Sunday=星期日
Monday=星期一
Tuesday=星期二
Wednesday=星期三
Thursday=星期四
Friday=星期五
Saturday=星期六
Use Public Holiday Table=使用公众假期表
Use Statutory Holiday Table=使用法定假期表
Use Roster Table=使用当值时间表
Manual Input=自定义
Override Minimum Wage=不理会最低工资
New Minimun Hourly Rate=新最低工时
Work Hour Pattern=工作时间模式
Total Number of Days=总日数
Work Injury Record=工伤记录
Rejoin with new Emp No.=用新雇员编号重新加入
Rest Payment=休息款项
Training Seminar Enroll List=训练课程登记序列 
Sort By=排序
Training Seminar Period=训练课程时期
TrainingCourse=训练课程
Function List=菜单
Include Employee Name, Company, Hierarchy and Position on every sheet (except Employee Personal Information) =包含雇员名称, 公司,公司架构及职位于所有工作表 (雇员个人资料除外) 
Decimal Place(s) for Leave Balance Display=显示休假结余小数字
Use Work Hour Pattern=使用工作时间模式
Skip Public Holiday Checking=略过公众假期检查
Skip Statutory Holiday Checking=略过法定假期检查
Statutory Minimum Wage Setup=法定最低工资设定
Employee Working Summary=雇员工作摘要
List=序列
Import Employee Working Summary=导入雇员工作摘要
Hourly Rate=时薪
Export Employee Working Summary=导出雇员工作摘要
Export Employee Working Summary Template=导出雇员工作摘要范本
Import Date=导入日期
Uploaded by=上载人
Stop Payment=停止付款
Claims and Deductions Import History=索偿与扣减导入纪录
Trial Run Date=试算日期
Trial Run By=试算人
Generate AutoPayList (Excel)=制作自动转账列表 (电子表格)
Direct Debit=直接入账
Re-activate Payroll Process=重新启动支薪程序
Pass code for Re-activate=重新启动支薪周期密码
Re-activate=重新启动
Re-activate Payroll Cycle=重新启动支薪周期
Hierarchy Level Mapping to Site Code=当值地点公司架构配对
Roster Client Site Setup=当值客户地点设定
Meal Break Time (mins)=用膳时间(分钟)
Meal Break Unit=用膳时间计算单位
hour(s)=小时
Daily Payment=日薪
No Rounding=不进位
File has header=有档案标题
No time card records=没有拍卡纪录
Print Mapping List=制作配对列表
Payment not mapped to any taxation payment=没有配对于税务类别的支薪代号
PARAM_CODE_SESSION_TIMEOUT =闲置超时 (分钟)
Keep Connected=保持联机
Remind Day(s) Before =发生日前提醒
Remind Day(s) After =发生日后提醒
A.M.=上午 
P.M.=下午 
Active / Will be terminated=在职 / 即将离职
Will be terminated / Terminated=即将离职 / 已离职 
(none)=(无)
Close=关闭
Select All=选择所有
Unselect All=取消选择所有
More=更多
All=全部
Non-payroll Item=非支薪项目
Compensation Leave Entitlement=补假获得
Hours Claim=索取时间
Approved By=批核者
Compensation Leave Entitlement History=补假获得记录
Display All Records=显示所有记录
Display Latest Record(s) Only=只显示最近记录
Import Employee Information=导入员工数据
Import Leave Balance Adjustment=导入休假结余调整
Active Company=现有公司
Active Users=现有用户
Average Basic Salary=平均基本薪酬
Copyright=版权
New Emp. No=新员工编号
Password for ZIP file=ZIP档案的密码
Previous Emp. No.=上一个员工编号
Recurring Basic Salary=定期支付的基本薪酬
Ver. =版本
English Name=英文姓名
Net Payment=净薪金
Non-Relevant Income=非有关入息
Wages Payable for Min Wages=最低工资条例下须支付的工资
Total Hours Worked=总工时
Min Wages Required=法例要求的最低工资
Employer Mandatory Contribution=雇主强积金供款
Employer Voluntary Contribution=雇主自愿性供款
Employer P-Fund Contribution=雇主公积金供款
Total Employer Contribution=雇主总供款
Total Employee Contribution=雇员总供款
Total Taxable Payment=总课税额
Total Non-Taxable Payment=总非课税额
Amount (HK$)=款额(港元)
Date of Bank File Generated=银行档案制作日期
Use Common Leave Year=使用共同假期年
Common Leave Year Start Date=共同假期年开始日期
Year of Service Calculation Method=年资计算方式
Rest Day Options=休息日选项
Enable Statutory Holiday Entitlement in Employee Leave Balance=在休假结余里启用法定假期日数获取
Enable Rest Day Entitlement in Employee Leave Balance=在休假结余里启用休息日日数获取
Number of Rest Day Entitled=休息日获得日数
day(s)=日
per month=每月
per week=每星期
Week to gain Rest Day for Weekly Entilement=休息日获得的星期
Number of day for prorata calculation=按比例计算时用的基础日数
Forfeit Last Year BF Record=丧失上年度的带假记录
Final Payment Statement=最后工资结算表
FINAL PAYMENT STATEMENT REPORT=最后工资结算表
Statutory Minimum Wage Summary Report=法定最低工资报表
Long Service Payment / Severance Payment Estimation List =长期服务金 / 遣散费预算表
Employee Compensation Leave Entitlement=员工补假获取
Roster Table Overview=编更表概要
Roster Table Group Setup=编更表组别设定
Generate Compensation Leave Entitlement=制作补假获取
Training Seminar Enroll=训练课程登记
Training Course Setup=训练科目设定
Employee Self Service=员工自助服务
Default Language=默认语言
Update Employee Information=更新员工数据
Roster Table=编更表
Employee Reports=员工报告
Payroll & MPF Reports=支薪及强积金报告
Taxation Reports=税务报告
--- Show All Functions ---=--- 显示所有功能 ---
Apply on first year brought forward only=只适用于第一年带假
Determined by Date of Join=以入职日期来计算出来
Show all bank account =显示所有银行户口
Press &quotCtrl&quot for multiple selection=请按着"Ctrl"键来选择多个项目
Users=用户
Emp No. (if any)=员工编号(如有)
Show Header Only =只显示标题
Show header without data update=显示没有任何更改记录的标题
Show Internal ID Only (Without Item Description)=只显示系统内部用的识别编号(不会提供任何描述)
Notice Date of Termination=离职通知日期
Expected Last Employment Date=预计最后工作日期
Actual Last Employment Date=实际最后工作日期
Default Bank Account=预设的银行户口
Invalid User Name or Password=用户名称或密码不正确
Account is Inactive/Locked=账号已经无效/被锁
Account is Locked=账号已经被锁
Use Payment Code for Leave Allowance as Deduction Code if net payment is $0=当净款额为$0时以 "休假津贴的支薪代号" 作为扣减代号
Skip Payroll Process=不作支薪计算
Payroll Process on Next Month=下一个月才作支薪计算
Hide in ESS=在员工自助服务中隐藏
ERROR_BANKFILE_NEGATIVE=银行档案不应该包含负数
Taxation Generated Before=已完成税务制作
ERROR_NO_EMPLOYEE_SELECTED=没有选择员工
Learning Method=学习方式
Default Cost Center=预设的成本中心
Distance Learning=遥距学习
On-Campus=校内
Check Every Year=每年检查
Exclude first 3 month probation period=不包括试用期首3个月
View Work Hour Pattern=检视工作时间模式
Edit Work Hour Pattern=编辑工作时间模式
Relevance Experience=相关经验
Roster Table Group=更表组别
View Work Injury Record=检视工伤记录
Use Existing Formula=使用现有公式
Copy=复制
Rest day with pay=有薪休息日
Meal break with pay=有薪用膳时间
Additional Remuneration=额外报酬
Total Working Hours=总工作时数
Total Wages for Minimum Wages=以最低工资条例计算的总工资
Minimum Wages Required=须支付的最低工资
Working Hours Count for this payroll Section=此支薪程序的工作时数
Year End Bonus=年终奖金
Roster Table Group Search=编更表组别搜寻
Roster Table Group List=编更表组别序列
View Roster Table Group=检视编更表组别
Save Settings=储存设定
Import to Claims and Deductions=导入至索偿与扣减
Sub-Scheme No.=附属计划编号
Group No.=团体号码
Sub-group No.=附属团体号码
Color Code=色码
Ignore -ve sign when rounding=当进位不理会正负号
Day Unit=工作日单位
Working hour per day=每日工作时数
Meal break hour per day=每日用膳时数
Auto Fill=自动填写
Supervisor=管理人
View Compensation Leave Entitlement=检视补假获得
No. of Hours Claim=索取时数
Claim Time=索取时间
Claim Period=索取周期
Adjust Value=调整数值
Payment Code for AL Compensation by Employee=有薪年假雇员补偿支薪代号
Payment Code for Rest Day Compensation=休息日补偿支薪代号
Payment Code for Statutory Holiday Compensation=法定假期补偿支薪代号
Minimum period of employment for AL Compensation=有薪年假的最少雇用期
Daily Formula for Rest Day Compensation=每日休息日补偿公式
Daily Formula for Statutory Holiday Compensation=每日法定假期补偿公式
Default Prorata Formula=按比例计算预设公式
Rest Day Prorata Formula=休息日按比例计算公式
Payment Code for Additional Remuneration (for Statutory Minimum Wage)=(法定最低工资)额外报酬的支薪代号
Meal Break Duration=用膳时数
Minimum Working Hour for Meal Break=获得用膳时间的最少工作时数
Partial Bonus Condition=部份考勤奖金条件
Gain as Compensation Leave Entitlement=以补假换取
Payroll Prorata Formula for Absent=缺席按比例计算公式
Compensated late/early leave by Overtime=以超时工作抵消迟到/早退
Payment Code for Bonus Payment=考勤奖金的支薪代号
Percentage of Bonus=考勤奖金的百分比
Prorata for New Join Employees=新入职雇员按比例计算
Prorata for Terminated Employees=离职雇员按比例计算
Entitle bonus for terminated employee worked with incompleted month=离职雇员在不完整月应获得考勤奖金
Auto E-mail Audit Trail=自动寄出审计追踪
E-mail Address=电邮地址
Separate address with ENTER=换行分隔地址
Prorata on Claims and Deductions=按比例计算索偿与扣减的金额
View=检视
Check every leave year for prorata of Annual Leave=检查每一个假期年的年假按比例计算
Comparison between formula=公式比较
Comparison between result =结果比较
Use Claims and Deduction for Daily/Hourly Recurring Payment=每日/每小时的定期支薪以索偿与扣减数据计算
Payroll trial run process is completed =支薪试算完成
Payroll trial run is processing=支薪试算进行中
Undo Successful=还原支薪试算完成
Complete=完成
Stop Payment Successful=停止付款完成
Paid Date is updated=支付日期已更新
Are you sure to end this payroll process?=是否确定结束此支薪程序? 
Are you sure to rollback to previous payroll process?=是否确定还原支薪程序? 
ARE_YOU_SURE_TO_CONFIRM="是否确定?";
Rollback Complete=还原支薪程序完成
Late/Early Leave Setting=迟到/早退设定
Late Unit=迟到单位
Meal Break Late Unit=用膳时间迟到单位
Early Leave Unit=早退单位
Meal Break Early Leave Unit=用膳时间早退单位
Included Meal Break Early Leave=包括用膳早退
Included Meal Break Late=包括用膳迟到
Include Meal Break Early Leave=包括用膳早退
Include Meal Break Late=包括用膳迟到
OT Rate and Override Hourly Rate will not take effect=不理会超时工作比率及新时薪设定
Override Amount from Recurring Payment =不理会定期支薪款额
Roster Client Site List=当值客户地点列序
Attendance Record Generation is completed=制作考勤纪录完成
Import Sucessful=导入成功
Taxation records are generating…=税务记录制作中…
Taxation records are generated successfully=税务记录制作完成
Message for Relevant Certificate Alert=相关证明提示讯息
Authorization Group Search=批核组别搜寻
Authorization Group Detail=批核组别详情
MPF Termination Code=强积金离职代号
Unlimited=无限
PRODUCT_TYPE=产品类型
MAX_EMPLOYEES=最多现职员工数目
Active Employees=现职员工
Message for Relevant Certificate Alert:=相关证明提示讯息:
ERROR_MAX_LICENSE_LIMITCH_REACH=已经达到最大许可限制 ({0})! 动作终止!
Skip MPF calculation if recurring payment calculation does not exist =如果未有计算定期支薪，略过强积金计算
(keep empty if Overtime start immediately)=(保持空白如超时工作立即生效)
(keep empty if Overtime do not have limit)=(保持空白如没有超时工作上限)
Include OT at Meal Break=超时工作计算包含用膳时间
Include Meal Break Overtime=包括用膳时超时工作
Meal Break Late (mins)=用膳迟到(分钟)
Meal Break Early Leave (mins)=用膳早退(分钟)
Meal Break Overtime (mins)=用膳超时工作(分钟)
Recalculate result from IN/OUT record=以开始/结束工作时间重新计算结果
Location Mapping=工作地点配对
Location Name=工作地点名称
Mapped to=配对至
Roster Time Override=新当值时间
Actual=拍卡时间
PAYROLL_UNDO_CLICK_MESSAGE=确认要还原这个大量导入吗?
New Join Employee List=新入职员工列表
Employee Probation List=员工试用期列表
Imported by=导入者
Scheme Name=计划名称
Next Sequence No.=下一个序号
Employer Plan No=雇主计划编号
Employee Filter =雇员过滤器
Do NOT apply rounding rule while calculating balance of Annual Leave=在计算年假结余时不要使用进位规则
REPORT_GENERATING_TO_INBOX=报表正在制作中 ，请稍后检查收件匣。
First Hierarchy Level Display=第一个商业层级显示为
Second Hierarchy Level Display=第二个商业层级显示为
Refresh=重新整理
Attachment=附件
This amount must also be included in details of income paid or payable=此款额必须包括在详细入息内
Prorata Formula Options=按比例计算公式选项 
Rest Day=休息日
Change of Payroll Group or Recurring Payment=更改支薪组别或定期支薪
Skip Statutory Holiday Calculation=略过法定假期计算
Default Formula=预设公式
ERROR_SAAS_FILE_SUBMIT_AFTER_CUTOFF=档案递交服务已经于 {0} 后停止服务, 请于明天 {0} 前再尝试
PRODUCT_TRIAL_WILL_EXPIRE=试用期将于 {0} 天后完结.
ERROR_FIELD_REQUIRED={0} 是必须的
ERROR_DATE_FORMAT=日期格式错误 !
MESSAGE_COST_CENTER_NOT_FOUND=员工 ({0}) 的成本中心尚未设定.
ERROR_AVCPLAN_CEILING_NOT_NUMERIC={0} 的最大限额不是数字
ERROR_COSTCENTER_PERECNTAGE_NOT_NUMERIC={0} 的成本中心百分斗率不是数字
ERROR_REMINDER_DAYS_NOT_NUMERIC={0} 的日数不是数字
Rest Day Entitled=应得休息日
Rest Day Taken=已取休息日
Total Working Day(s)=总工作日数
Total Hours for Meal Break=总用膳时数
ERROR_SURNAME_CONTAIN_SPACE=姓氏不可以有空白格
ALERT_NEW_STAFF_NO_BEEN_USED=雇员编号{0}已经被其他员工使用，已经赋予了新的雇员编号{1}。
BANKFILE_CONSOLIDATION_MESSAGE=上载支薪/强积金档案的截数时间为星期一至星期六下午5:00正(公众假期除外)。
BANKFILE_CLEARING_MESSAGE=因银行五天结算, 转账服务只会在星期一至星期五进行(公众假期除外)
BANKFILE_REPORT_STORE_PERIOD_MESSAGE=所有银行讯息只供储存90天，之后将会被自动删除 。请于收取讯息后，下载所有的报告以供备存。
e-Channel=电子渠道
Submit Autopay File=递交自动转账档案
Submit MPF Contribution File=递交强积金档案
Notification=通告
Registered Bank Payment Code=已登记的银行转账代号
Bank Payment Code=银行转账代号
Consolidate Date=收集日期
Transaction Reference=交易参考编号
Autopay In/Out=自动入账/支账
Date Received=收取日期
Total Size=总用量
Confirm By:=确认人:
Message Detail=信息详情
Submit via e-Channel=经由电子渠道递交
Employment Type Code Setup=雇用型式代号设定
Cessation Reason Code Setup=离职原因代号设定
Position Code Setup=职位代号设定
Qualification Code Setup=学历代号设定
Skill Code Setup=技能代号设定
Skill Level Code Setup=技能级别代号设定
Rank Code Setup=阶级代号设定
Staff Type Code Setup=职员种类代号设定
Release Pay Slip to ESS=发放支薪通知书到雇员自助系统
e-channel Notification=电子渠道通告
Modify user accounts with less permission only=只能变更较低等级用户
Show Key ID Only=只显示内部索引
Prepared by=制作人
Reviewed by=验证人
Skip Deduction=略过扣减计算
Applicable only if deduction formula and allowance formula is different=只适用于不同的扣减与津贴公式
Permit Type Code Setup=许可证类别代号设定
Document Type Code Setup=文件类别代号设定
Cost Center Code Setup=成本中心代号设定
OK=确定
Calculate as daily=以日薪方式计算
Prorata Formula=按比例计算公式
Company Bank Account Setup=公司银行户口设定
Bank Account List=银行户口列表
View Company bank Account=检视公司银行户口
Company bank Account=公司银行户口
Business Hierarchy=商业层级
Sub-Total=小计
Last Working Date=最后工作日期
Effective Date of Termination=离职生效日期
Reason for Termination=离职原因
EMPLOYEE DETAILS=雇员资料
Employee's Name=雇员姓名
Staff No.=雇员编号
ID No.=身份证号码
Job Title=职位
Date Joined=入职日期
Current Salary=现有薪金
TERMINATION DETAILS:=离职数据:
Employee's Signature=雇员签署
I, \n{EmpInfo.EmpName}\n hereby accept & confirm the above payment as the final settlement from \n{EmpInfo.CompanyName}\n and further confirm that I have no other claims against \n{EmpInfo.CompanyName}\n and its affiliates.=我 \n{EmpInfo.EmpName}\n 在此接受并确认上述款额为\n{EmpInfo.CompanyName}\n 的最终结算，并进一步确认，我没有对 \n{EmpInfo.CompanyName}\n 及其附属公司有其他索偿请求。
Name of Scheme=计划名称
Scheme Registration No.=计划注册编号
Name of Contact Person=联络人姓名
Telephone No.=电话号码
Existing Employee Section=现有雇员部分
Name of Employee=雇员姓名
YYYY/MM/DD=年年年年/月月/日日
Mandatory Contributions=强积金供款
Voluntary Contributions=自愿性供款
Employer 5%=雇主 5%
Employee 5%=雇员 5%
Term Code=离职代号
Employee entitlement=雇员应获得的总额
Please Specify LSP or SP=请注明长期服务金或遗散费
LSP/SP paid or to be paid to employee by Employer=已/将由雇主支付予雇员之长期服务金/遗散费
New Employee Section=新入职雇员部分
For your convenience, we have provided the mandatory contribution details below based on the relevant income from your last settled Remittance Statement.=为了你的使用更为方便，从强积金付款结算书中我们提供了以下基于有关收入而所计算的强制性供款。
If the data for the current contribution period is different, please delete it and insert the correct amount.=假若现时的供款期有所更改，请删除并重新输入正确的金额。
FINAL PAYMENT CALCULATION:=最后工资计算结果:
Termination codes=离职代号
WB - Withdrawal=辞职
RE - Redundancy=裁员
DS - Summary dismissal=实时革职
ER - Early retirement=提早退休
NR - Normal retirement=正式退休
LR - Late retirement=延迟退休
PC - Termination prior to commencement of contribution=开始供款前离职
DN - Death=死亡
GO - Member transfer between companies=成员于公司之间调职
PD - Permanent departure from Hong Kong=永久性地离开香港
TI - Total incapacity=完全丧失行为能力
(please provide your employee with a letter certifying that his/her contract of employment for that particular kind of work has been or will be terminated)=（请为雇员提供由贵公司发出的信件，证明他／她就该特定工作的雇佣合约己予或将予终止）
First Name=名字
Name (in English)=姓名 (英文)
Sex (M/F)=性别 (男／女)
Identitiy Type=证件类别
This section is only applicable for reporting employees who have been employed for 60 days (for non-casual employees) / 10days (for casual employees) but are not shown in the 'Existing Employees section'.=本部分仅适用于员工工作日刚满60天（非临时雇员）/10天的临时雇员，但不显示在“现有雇员项”的报告。 
Please report relevant income and contributions for EACH contribution period .=请报告的每一供款期的有关入息及供款。
Additional Employee Termination Information Section=额外离职雇员数据部分
Identitiy No=证件号码
Member Type=成员类别
Date joined scheme=参加计划日期
ClassNo=级别号码
For reporting termination of employees in the 'New Employees section', please leave the 'Last payroll details' blank.=如汇报任何新雇员部分的雇员之离职详情, 请毋须填写"最后受薪详情"。
Please report relevant income and contributions for EACH contribution period.=请提供雇员每一个供款期的有关入息及供款。
Last Contribution Period=最后供款期
HKID / Passport=香港身分证／护照号码
Last payroll details=最后受薪详情
Employee entitlemnt (Please specify LSP or SP)=雇员应获得的总额（请注明长期服务金或遣散费）
LSP/SP paid or to be paid employee by Employer=已／将由雇主支付予雇员之长期服务金／遣散费
Back-payment for Terminated Employee Section=已离职雇员的补薪部分
This section is only applicable for reporting any back-payment made to employees whose termination has previously been reported.=此部分只适用于为之前已作出通知的离职雇员而汇报的任何补薪。
Subtotal=小计
Display Code Only=只显示代号
Normal=日更
Overnight=通宵更
Statutory Holiday=法定假期
Settings for Plain Text/CSV=CSV及文本文件设定
Use settings under Roster Code if available =使用当值时间表的工作小时
Emp. No=雇员编号
Start Date for Leave Application History=休假申请显示开始日
Start Date for Pay Slip Printing=支薪通知书显示开始日
Automatically release the Pay Slip to ESS=自动发放支薪通知书到雇员自助系统
Create (temporary) attendance record if record does not exists=将建立一个暂时的考勤纪录假如本身的纪录并不存在
Add:=支付项目:
Deduct:=扣减项目:
Customer ID:=客户编号:
First Period Leave Cut Off Day=第一周期休假截数日
Second Period Start Day=第二周期开始日
Second Period Leave Cut Off Day=第二周期休假截数日
Semi-Monthly=每半月
Deduction Formula:=扣减公式:
Allowance Formula:=津贴公式:
Payment Code for Deduction:=扣减的支薪代号:
Payment Code for Allowance:=津贴的支薪代号:
Leave Calculation Override=休假计算依支薪组别设定
INBOX_SIZE_EXCEEDED=已超越收件匣容量上限, 请删除部份信息
User Guide=使用手册
PARAM_CODE_HKID_CHECKDIGIT_AUTO_GENERATE=自动产生香港身分证的验证码
Inbox size used=已使用的收件匣空间
Use Public Holiday Table instead of Statutory Holiday Table=用公众假期表取代法定假期表
Request Cancel due to No Authorizer for this employee=由于没有批核者, 申请取消
Internal Email=内部电邮
Request From=申请要求日期
Submit Date=递交日期
Modify Date=修改日期
Request Type=申请类型
Authorize=批准
Reject=拒绝
Request Cancel due to No Authorizer=由于没有批核者, 申请取消
Submit=递交
Leave Balance Enquiry=查询休假结余
Leave History Enquiry=查询休假纪录
Request Status=申请状况
Payslip Printing=打印支薪通知书
Request Employee Info Changes=更改雇员数据申请
Date of Submit=提交日期
Preview=预览
REQUEESTSTATUS_ALL=全部
REQUEESTSTATUS_PROCESSING=处理中
REQUEESTSTATUS_END_PROCESS=接受/拒绝/取消
The leave application is cancelled=假期申请已经取消
Reason=原因
Expired=过期
Will expire=将会过期
Leave Application Cancellation=取消假期申请
Application Approval=批核申请
Delegate Employee No.=委任(偏员编号)
Awaiting your approval=等候批核
Awaiting other groups approval=等候其他组别批核
Approval History=批核纪录
Submitted=已提交
Action Date=操作日期
Leave Balance Report=休假结余报表
ESS_EmpLeaveBalanceReport.AsOfDate=直至
Tax Report Printing=打印税务报表
Current entitlement is not available for leave applications=本年度应得假期将不可申请
Cancel Leave Application=取消已批假期
Date Expiry=有效日期
ESS Options=雇员自助服务设定
Hide Leave Balance in ESS=隐藏休假结余
Do not allow to apply leave application if the employee does not have enough leave balance as at=在以的情况如果雇员的休假结余不足申请假期将不被接纳
date of submit=递交申请时
first date of leave application=首天放假
last date of leave application=放假的最后一天
last date of leave year=年度的最后一天
Show Medical Cert. Option=显示医生证明选择
Enable Public Holiday Entitlement in Employee Leave Balance=在休假结余里启用公众假期日数获取
Max. B/F=最多带假
Day(s)=日
Expiry after=有效期
Month(s)=个月
Import Compensation Leave Entitlement=导入补假获得
second formula for comparsion:=比较款额
Release Tax Report to ESS=发放税务报表到雇员自助系统
Pay Slip Report (Dot Matrix)=支薪通知书(电话密码纸版)
Authorization Workflow Setup=批核流程设定
ESS Authorization Workflow Setup=雇员自助服务批核流程设定
Reason for Cancel=取消原因
Cancelled=已取消
Public Holiday Options=公众假期选项
Re-Calculate All Staff's Leave Balance=重新设算本计划内员工假期结算
ESS_EmpLeaveApplicationList.PeriodFrom=日期 由
ESS_EmpLeaveApplicationList.PeriodTo=至
Payroll allocation report - details=薪金配置详细报告

KHL_CPSL.Seq=
KHL_CPSL.EmpNo=雇员编号 
KHL_CPSL.Alias=別名
KHL_CPSL.EnglishName=名称
KHL_CPSL.Position=职位
KHL_CPSL.DateJoin=入职日期
KHL_CPSL.RPBasicSalary=每月基本薪金
KHL_CPSL.Remarks=備註
KHL_CPSL.BLANK=
KHL_CPSL.NetPayment=净薪金
KHL_CPSL.RelevantIncome=有关入息 
KHL_CPSL.NonRelevantIncome=非有关入息
KHL_CPSL.WagesPayableForMinWages=最低工资条例下须支付的工资
KHL_CPSL.TotalHoursWorked=总工时
KHL_CPSL.MinWagesRequired=法例要求的最低工资
KHL_CPSL.EmployerMandatoryContribution=雇主强积金供款
KHL_CPSL.EmployerVoluntaryContribution=雇主自愿性供款
KHL_CPSL.EmployerPFundContribution=雇主公积金供款
KHL_CPSL.TotalEmployerContribution=雇主总供款
KHL_CPSL.TotalEmployeeContribution=雇员总供款
KHL_CPSL.TotalTaxablePayment=总课税额
KHL_CPSL.TotalNonTaxablePayment=总非课税额

PROOM_CPSL.Company=公司
PROOM_CPSL.EmpNo=雇员编号
PROOM_CPSL.EnglishName=名称
PROOM_CPSL.Alias=别名
PROOM_CPSL.HKID=身份证编号
PROOM_CPSL.JoinDate=入职日期
PROOM_CPSL.ServiceStartDate=服务日期
PROOM_CPSL.Position=职位
PROOM_CPSL.CurrentBasicSalary=现时基本薪酬
PROOM_CPSL.HeadCount=雇员人数
PROOM_CPSL.NetPayment=净薪金
PROOM_CPSL.EmployerMandatoryContribution=雇主强积金供款
PROOM_CPSL.TotalMandatoryContribution=总强积金供款
PROOM_CPSL.RelevantIncome=有关入息
PROOM_CPSL.NonRelevantIncome=非有关入息

Benefit Plan Setup=褔利计划设定
Benefit=褔利
Beneficiaries=受益人
Incentive Payment Process=奖励金程序
Bonus Process=奖金程序
Double Pay=双粮
Cost Center Export Report=导出成本中心报告
Living Apart=分居
Commission Achievement Process=佣金成就计算
Double Pay Adjustment=双粮调整

Cancelled Leave Application=已取消的休假申请
EmergencyContact=紧急联络数据
Disabled=已停止
Leave Application Unit=申请休假单位
Show Relevant Cert. Option=是否须要出示有关证明书
Deduction Formula=扣除公式
Payment code for deduction=扣减的支薪代号
Allowance Formula=津贴公式
Payment code for allowance=津贴的支薪代号
Remote Profile for HSBC/Hang Seng=恒生或汇丰的远程配置文件编号
Bank=银行
remote Profile ID=远程配置文件编号
Signed by=签署
Auto generate Staff Number=自动产生员工编号
New Staff Number format=新员工格式
{9} - any digit, {Other Characters} - any fixed character. e.g. Format = A-99999 means the staff number starts with 'A-' and with 5 digit, where 'A-00301' is a valid staff number.={9} - 任何数字，{其他字符} - 任何固定的字符。例如格式= A-99999是指以'A-'，并与5位数字，其中“A-00301”是一个有效的员工编号。
PayScale Master=总薪级表
PayScale Points Master=总点数薪级表
Payscale - Salary Increment Batch=薪级表 - 加薪批次
Payscale - Backpay Template Export=薪级表 -补发工资范本导出
F&V Monthly Achievement=每月成就
e-channel Signature Setup=设定电子渠道的签署
Employee Benefit=员工福利
Employee Beneficiaries=福利受益人
Monthly Achievement=每月达标率
Incentive Payment=鼓励款项
Import Compensation Leave Entitlement=导入补偿休假权利
File Format=文件格式
Applied to=适用于
Generate Claims And Deduction=制作索偿与扣减

Import Batch=导入批次
Payment Date=支薪日期
Import Commission Achievement=导入佣金成就
Commission Achievement Import History=佣金成就导入纪录
Export Commission Achievement Template=导出佣金成就范本
Export Claims And Deduction Template for Commission Achievement=制作索偿与扣减(佣金成就)

Import Incentive Payment=导入鼓励款项
Incentive Payment Import History=鼓励款项导入纪录
Export Incentive Payment Template=导出鼓励款项范本
Export Claims And Deduction Template for Incentive Payment=制作索偿与扣减(鼓励款项)

Double Pay Adjustment Process=双粮修订
Commission Employee List=佣金制度员工列表
Import Double Pay Adjustment=导入双粮修订
Double Pay Adjustment Import History=双粮修订导入纪录
Export Claims And Deduction Template for Double Pay Adjustment=制作索偿与扣减(双粮修订)

Select Employee=选取员工

(Disabled)=(停用)
Overall Payment Summary=整体支薪摘要
CL Requisition=补假申请
CL Requisition History=补假申请纪录
Late Waive=撤回迟到申请
Late Waive History=撤回迟到申请纪录

Monthly Attendance Report=每月考勤报表
Input in/out Time=输入上/下班时间
Timecard Record=打咭纪录
Leave Application List=休假申请纪录

CL Requisition=补假申请
CL Requisition History=补假申请纪录

HKID is already input in system, click SAVE button again to bypass this warning and save to database=香港身份证号码已被用于另一位员工使用，如要储存，请按「确定」后再按「储存」键一次
