lang.EN=英文
lang.GB=GB
label.Page=頁
label.Total=總數
label.Records=記錄

combobox.notselected=未選擇
validate.prompt=輸入不正確
validate.list.required=必須
validate.list.required.prompt2={0} 是必須的
validate.list.required.prompt=請選擇{0}
validate.required=必須
validate.required.prompt={0} 是必須的
validate.date=日子不正確
validate.date.prompt={0} 並非正確日子
validate.double=數子不正確
validate.double.prompt={0} 並非正確數字
validate.int= 數子不正確
validate.int.prompt={0} 並非正確整數
validate.intrange={0} 超出範圍
validate.toobig=數值過大
validate.toobig.prompt={0} 過大
validate.toosmall=數值過少
validate.toosmall.prompt={0} 過少
validate.posnum=是一個正數
validate.posnum.prompt={0} 並非一個正數
validate.maxlength=數值過長
validate.maxlength.prompt={0} 過長


AVC below MAX=少於或等於最高有關入息時的供款百分比
AVC above MAX=大於最高有關入息時的供款百分比
Accommodation=住處
Bank Account Number=銀行戶口號碼
Account No=戶口號碼
Additional Voluntary Contribution=自願性供款
Additional Voluntary Contribution Plan=自願性供款計劃
Address=地址
Address of Employer=僱主地址
Adj Type=調整類別
Adjust=調整
Adjust Date=調整日期
Alias=別名
Amount=款額
Amount with unit=款額
Any money held under Section 52(7) of the Inland Revenue Ordinance=有無依據稅務條例第52(7)條規定扣起任何款項
As Of Date=指定日期
Attendance From=考勤由
Attendance Period=考勤周期
Attendance To=考勤至
AVC Plan=自願性供款計劃
AVC Plan List=自願性供款計劃序列
AVC Plan Search=自願性供款計劃搜尋
AVC Plan Setup=自願性供款計劃設定
Balance=結餘
Bank Account=銀行戶口
Bank Account No=銀行戶口號碼
Bank Code=銀行代號
Bank File Type=銀行檔案類別
BF=帶假
BR=商業登記證
BR No.=商業登記證號碼
Branch Code=分行代號
Business Hierarchy List=商業層級序列
Business Hierarchy Search=搜尋商業層級
Business Hierarchy Setup=商業層級設定
Capacity in which employed=受僱職位
Cessation Reason=離職原因
Change Password=更改密碼
Change Password Period=更改密碼周期
Chinese Name=中文姓名
CitiBank File Detail=花旗銀行自動轉脤檔案
Claims and Deductions=索償與扣減
Claims and Deductions Detail=索償與扣減詳情
Code=代號
Company=公司
Company Address=公司地址
Company BR No=公司商業登記證號碼
Company Code=公司代號
Company Contact Person=公司聯絡人
Company List=公司序列
Company Name=公司名稱
Company Search=公司搜尋
Company Setup=公司設定
Confirm=確認
Confirm Date=確認日期
Confirm New Password=確認新密碼
Confirm Password=確認密碼
Contact Name=聯絡人名稱
Contract No.=合約號碼
Contact No.=聯絡號碼
Contact Person=聯絡人
Contracts=合約
Contribute for age over MPF maximum age limit=超過強積金最高年齡限制時仍繼續供款
Contribute for income less than MPF minimum relevant income=低於最低有關入息時仍繼續供款
Correspondence=通訊地址
Postal Address=通訊地址
Postal address after departure=離港後的通訊地址
Country Issued=發證國家
Current=現在
Current Date=現在日期
Customer Reference=用戶參考
Date=日期
Date From=由
Date of Birth=出生日期
Date of Grant=發給認購權日期
Date of Joining=入職日期
Date Range=日期範圍
Date To=至
Day=日
Days Entitled=應得日數
Days Taken=已取日數
Decimal Place=小數位
Default Next Period From=由預設下一周期
Default Next Period To=至預設下一周期
Dependant=家屬
Desc=描述
Description=描述
Designation=職位
Detail=詳情
Edit=編輯
Edit  Employee Profile=編輯僱員資料
Edit Accommodation=編輯住處
Edit AVC Plan=編輯自願性供款計劃
Edit Bank Account=編輯銀行戶口
Edit Business Hierarchy=編輯商業層級
Edit Contract Terms=編輯合約條款
Edit Dependant=編輯家屬
Edit Employee Skill=編輯僱員技能
Edit Final Payment=編輯最後工資
Edit Leave Adjustment=編輯休假調整
Edit Leave Application=編輯休假申請
Edit Leave Type=編輯休假類別
Edit MPF Plan=編輯強積金計劃
Edit ORSO Plan=編輯職業退休計劃
Edit P-Fund Plan=編輯公積金計劃
Edit Payment Code=編輯支薪代號
Edit Payroll Cycle=編輯支薪周期
Edit Payroll Formula=編輯支薪公式
Edit Payroll Group=編輯支薪組別
Edit Position Information=編輯職位資料
Edit Qualification=編輯學歷
Qualification=學歷
Edit Recurring Payment=編輯定期支薪
Edit Spouse=編輯配偶資料
Edit Taxation Category Mapping=編輯稅務種類配對
Edit Taxation Company=編輯稅務公司
Edit User=編輯用戶
Edit User Group=編輯用戶組別
Effective Date=生效日期
Effective From=生效由
Personal E-mail Address=私人電郵地址
Emp No=僱員編號
Employee=僱員
Employee AVC exemption period the same as MPF=僱員的自願性供款可享有強積金的免供款期
Employee Cont.=僱員供款
Employee Contact=僱員聯絡
Employee Contact Report=僱員聯絡報告
Employee Contribution=僱員供款
Employee Daily Average Wages Report=僱員平均工資報告
Employee Detail=僱員詳情報告
Employee Details Report=僱員詳情報告
Employee Head Count=僱員人數
Employee Head Count Report=僱員人數報告
Employee Info=僱員資料
Employee Information=僱員資料
Employee List=僱員序列
Employee List Report=僱員名單報告
Employee Name=僱員名稱
Employee No=僱員編號
Employee Overall Payment Summary=僱員整體支薪摘要
Employee Profile=僱員資料
Employee Report=僱員報告
Employee Search=搜尋僱員
Employee Setup=僱員設定
Employee Termination List=離職僱員名單
Employer=僱主
Employer Cont.=僱主供款
Employer Contribution=僱主供款
Employment Type=僱用型式
EmpNo=僱員編號
End=終結
estimated amount=估計款額
Existing Employee=現職僱員
Expiry Date=有效日期
Expiry After must be 0 when Max Days B/F is 0=沒有帶假情況下, 請於有效月數輸入0
Fax=傳真
Fax No.=傳真號碼
Final Pay Amount=最後工資款額
Final Payment Details=最後工資詳細資料
Final Payment Prorata Formula=最後工資比例公式
First Party Reference=第一方參考編號
First Period End Day=第一周期終結日
First Period Start Day=第一周期開始日
Fix Contribution Amount=固定供款額
Form=表格
Formula=公式
Formula Code=公式代號
Frequency=頻率
From=由
Function Permissions=允許功能
Future Postal Address of Employee=僱員將來的通訊地址
Gender=性別
Generate Bank File (By Payroll Group)=製作銀行檔案 (根據支薪組別)
Generate Bank File (By Payroll Cycle)=製作銀行檔案 (根據支薪期)
Generated By=製作者
Gratuity=賞金
Hierarchy Level=公司架構
Hierarchy Level Setup=公司架構設定
HKID=香港身份證號碼
Holder Name=持有人名稱
Home=住宅電話號碼
HSBC/Hang Seng Bank File Detail=香港匯豐銀行及恆生銀行自動轉賬檔案
Part time Employer Name=如為兼職， 他/她主要職業的僱主名稱
Institute=學校或機構名稱
Is AutoGen=是否自動計算
Is Default Account=是否預設戶口
Is MPF=是否強積金有關入息
Is P-Fund=是否公積金有關入息
Pro-rata Options=比例計算選項
Pro-rata when new join/terminated=當 新入職 / 離職 時按比例計算
Pro-rata for Leave=請假時按比例計算
Pro-rata for Statutory Holiday=法定假期時按比例計算
Is Voluntary=是否自願性供款有關入息
Is Wages=是否工資
Join Date=入職日期
Landlord=房東名稱
Landlord Address=房東地址
Last Date=最後工作日期
Last Employment Date=最後工作日期
Last Generation Date=最後製作日期
Leave=休假
Leave Adjustment=休假調整
Leave Allowance Formula=休假津貼公式
Leave Application & History Enquiry=休假申請及查詢休假紀錄
Leave Application cut off Date=休假申請截數日
Leave Balance=休假結餘
Leave Code=休假代號
Leave Code Search=搜尋休假代號
Leave Code Setup=休假代號設定
Leave Cut off Date=休假截數日
Leave Deduction Formula=休假扣減公式
Leave Hong Kong Date=離港日期
Leave Plan=休假計劃
Leave Plan Entitlement=休假計劃應得的權利
Leave Plan List=休假計劃序列
Leave Plan Search=搜尋休假計劃
Leave Plan Setup=休假計劃設定
Leave Recalculation=重新計算休假
Leave Summary=休假摘要
Leave Summary Report=休假摘要報告
Leave Type=休假類別
Leave Type List=休假類別序列
Leave Type Search=搜尋休假類別
Leave Type Setup=休假類別設定
Level=級別
Login Fail Count=登入失敗次數
Long Service Pay=長期服務金
Marital Status=婚姻狀況
Martial Status=婚姻狀況
Max AL=最多有薪假期
Max Daily=最多日薪供款
Max Monthly=最多月薪供款
Max SL I=最多病假類別I
Max SL II=最多病假類別II
Max. 12 character=最多12個位
Max. 16 character=最多16個位
Max. 3 character=最多3個位
Max. Annual Leave BF=有薪假期最多帶假日數
Max. employee's contribution=僱員供款上限
Max. employee's voluntary contribution=僱員自願性供款上限
Max. employer's contribution=僱主供款上限
Max. employer's voluntary contribution=僱主自願性供款上限
Max. Sick Leave Cat I BF=病假類別I最多帶假日數
Max. Sick Leave Cat II BF=病假類別II最多帶假日數
Method=方式
Min Daily=最少日薪供款
Min Monthly=最少月薪供款
Miscellaneous Code Setup=雜項代號設定
Mobile No.=手提電話號碼
Monthly Payment x=每月工資 x
MPF Detail=強積金詳情
MPF Details List=強積金詳情清單
MPF Parameter : - Edit=編輯強積金參數
MPF Parameter ID=強積金參數編號
MPF Parameter List=強積金參數序列
MPF Parameter Name=強積金參數名稱
MPF Parameter Search=搜尋強積金參數
MPF Parameter Setup=強積金參數設定
MPF Plan=強積金計劃
MPF Plan List=強積金計劃序列
MPF Plan Search=搜尋強積金計劃
MPF Plan Setup=強積金計劃設定
MPF Remittance Statement=強積金付款結算書
MPFEE=僱員強積金供款
MPFER=僱主強積金供款
Name=名稱
Name and address of previous Hong Kong Employer=如以前曾在香港受僱 ，請敘明該僱主(商號)的名稱及地址
Name of Employer=僱主名稱
Name of overseas company=海外公司名稱
Name of Signature=簽名人姓名
Nationality=國籍
Nature=類型
Need to Change Password=登入後需要更改密碼
New employer name and address=新僱主的名稱及地址
New Join Employee=新入職僱員
New Join Prorata Formula=新入職的按比例計算公式
New Password=新密碼
Next=下一個
No Payroll Process=不要作支薪處理
no. of shares not yet exercised=未行使的認購股份數目
Notice Period=通知期
Occupational Retirement Schemes Ordinance Plan=職業退休計劃
Office=辦公室電話號碼
Old=過去的
Old Password=舊密碼
ORSO Plan=職業退休計劃
ORSO Plan List=職業退休計劃序列
ORSO Plan Search=搜尋職業退休計劃
ORSO Plan Setup=職業退休計劃設定
P-Fund Plan=公積金計劃
P-Fund Plan List=公積金計劃序列
P-Fund Plan Setup=公積金計劃設定
P-Fund Plan Search=搜尋公積金計劃
Other Name=名字
Other Name in Full=其他名字
Passport No.=護照號碼
Passport No=護照號碼
Passport Country=簽發國家
Passport Expiry Date=護照有效日期
Passport Issued Country=護照簽發國家
Password=密碼
Payment Comparison=比較款額
Pay Advance=預付
Pay Center=付款中心
Pay Group=支薪組別
Pay Method=支薪方式
Pay Ratio=比率
Pay Slip Report=支薪通知書
PayCodeID=支薪代號
Payment=支薪項目
Payment Code=支薪代號
Payment Code for Leave Allowance=休假津貼的支薪代號
Payment Code for Leave Deduction=休假扣減的支薪代號
Payment Code for Statutory Holiday Allowance=法定假期津貼的支薪代號
Payment Code for Statutory Holiday Deduction=法定假期扣減的支薪代號
Payment Code List=支薪代號序列
Payment Code Search=搜尋支薪代號
Payment Code Setup=支薪代號設定
Payment Detail=支薪詳情
Payment List=入息明細
Payment Type=支薪類別
Payroll=支薪
Payroll & MPF Report=支薪及強積金報告
Payroll Batch List=支薪檔案夾序列
Payroll Confirmation=支薪確認
Payroll Cycle=支薪周期
Payroll Cycle Information=支薪周期資料
Payroll Cycle Reference Date=支薪周期參考日期
Payroll Discrepancy List=支薪相差清單
Payroll Formula Setup=支薪公式設定
Payroll Formula List=支薪公式序列
Payroll Formula Search=搜尋支薪公式
Payroll Group=支薪組別
Payroll Group Setup=支薪組別設定
Payroll Group Information=支薪組別資料
Payroll Group List=支薪組別序列
Payroll Group Search=搜尋支薪組別
Payroll History Enquiry/Adjustment=過往支薪紀錄查詢及調整
Payroll History Detail Report=過往支薪詳情報告
Payroll History Summary Report=過往支薪摘要報告
Payroll Period=支薪期
Payroll Period From=支薪期由
Payroll Process End=結束支薪程序
Payroll Trial Run=支薪試算
Payroll Trial Run Adjustment=調整支薪試算
Payroll Trial Run Detail=支薪試算詳情
Payroll Trial Run Detail Report=支薪試算詳情報告
Payroll Trial Run Employee List=支薪試算僱員列
Payroll Trial Run Information=支薪試算資料
Payroll Trial Run Summary Report=支薪試算摘要報告
Pension=職業供款計劃
Period=周期
Period of employment=僱用期間
Personnel=人事
P-Fund Detail=公積金詳情
P-Fund Report=公積金報告
P-Fund Statement=公積金結算單
Phone=電話
Place Of Birth=出生地點
Plan Code=計劃代號
please specify=請註明
Position=職位
Position History=過往職位紀錄
Previous=上一個
probable date of return is=返港的大概日期為
Probation Last Date=試用最後日期
Probation Period=試用期
Process End=結束支薪程序
Process Month=處理月份
Product Code=產品代號
Profile=資料
Qualifications=學歷
R.I.=有關入息
Rank=階級
Ranks=階級
Read=讀取
Read/Write=讀取/寫入
Reason for Cessation=停止受僱原因
Reason for departure=離港原因
Record=記錄
Records=記錄
Recurring Payment=定期支薪
Recurring Payment History=過往定期支薪記錄
Reference Date=參考日期
Relationship=關係
Remark=備註
Rent Paid to Employer By Employee=由僱員付給僱主的租金
Rent Paid to Landlord by Employee=由僱員付給業主的租金
Rent Paid to Landlord by Employer=由僱主付給業主的租金
Rent Refunded To Employee=由僱主發還給僱員的租金
Report=報告
Reports=報告
Residential Address=住址
Resign Date=辭職日期
Resignation Date=辭職日期
Rollback=還原
Rollback Payroll Trial Run=還原支薪試算
Scheme No=計劃號碼
Scheme Number=計劃號碼
Security=保安
Service Start Date=服務日期
Severance Pay=遣散費
Sex=性別
Skill=技能
Skill Level=技能級別
Skills=技能
Spouse=配偶
Spouse HKID=配偶的香港身份證號碼
Spouse Name=配偶的姓名
Spouse Passport Country Issued=配偶的護照發證國家
Spouse Passport No=配偶的護照號碼
Staff Type=職員種類
Standard Chartered Bank File Detail=渣打銀行自動轉賬檔案
Start=開始
Start Contribute on Date of Join=供款由入職開始
Start Date of Service=服務開始日期
Status=狀況
Statutory Holiday Setup=法定假期設定
Statutory Holiday Allowance Formula=法定假期津貼公式
Statutory Holiday Deduction Formula=法定假期扣減公式
Statutory Holiday Payment Eligible After=法定假期的款項生效於
Statutory Holiday Year=法定假期年份
Surname=姓氏
System=系統
System Default=系統預設
System Defined=系統預設
Taken=已取
Tax File No.=稅務局檔案號碼
Taxation=稅務
Taxation Adjustment=稅務調整
Taxation Category Mapping=稅務種類配對
Taxation Company=稅務公司
Taxation Company Setup=稅務公司設定
Taxation Company Details=稅務公司詳情
Taxation Company Information=稅務公司資料
Taxation Company List=稅務公司序列
Taxation Company Search=搜尋稅務公司
Taxation Diskette Generation=製作稅務磁碟
Taxation Form Type=稅務表格類別
Generate Taxation Records=製作稅務記錄
Taxation Header=稅務上款資料
Taxation Info=稅務資料
Taxation Information=稅務資料
Taxation Payment Detail=稅務支薪詳情
Taxation Payment Type=稅務支薪類別
Taxation Report=稅務報告
Terminated Employee=離職僱員
Termination=終止僱用
Termination Details=終止僱用詳情
Termination Reason=離職原因
The employee's Salaries Tax borne by employer=僱員的薪俸稅是否由僱主支付
The following employee has not been confirmed=以下的僱員尚未完成支薪確定
The following employee has not been run=以下的僱員尚未完成支薪試算
the reason is=原因是
This amount must also be included in item 11=此款額必須包括在第11 項內
Time=時間
To=至
Total=總計
Transfer Company?=是否調職
Trial Run=試算
Trial Run Detail=試算詳情
Trustee=信託人
Trustee Name=信託人名稱
Type=類別
Unit=單位
Upload file path=上載檔案路徑
Use residual for employee=與僱員強積金對沖
Use residual for employer=與僱主強積金對沖
User=用戶
User Group Setup=用戶組別設定
User Group List=用戶組別序列
User Group Search=搜尋用戶組別
User Groups=用戶組別
User ID=用戶編號
User Info=用戶資料
User List=用戶序列
User Maintenance=用戶設定
User Name=用戶名稱
User Search=搜尋用戶
Value=數值
Value Date=過賬日
VCEE=僱員自願性供款
VCER=僱主自願性供款
View Accommodation=檢視住處
View AVC Plan=檢視自願性供款計劃
View Bank Account=檢視銀行戶口
View Business Hierarchy=檢視商業層級
View Company=公司檢視
View Contract Terms=檢視合約條款
View Dependant=檢視家屬
View Employee Profile=檢視僱員資料
View Employee Skills=檢視僱員技能
View Final Payments=檢視最後工資
View Leave Adjustment=檢視休假調整
View Leave Application=檢視休假申請
View Leave Code=檢視休假代號
View Leave Plan=檢視休假計劃
View Leave Plan Entitlement=檢視休假計劃的應得權利
View Leave Type=檢視休假類別
View MPF Plan=檢視強積金計劃
View ORSO Plan=檢視職業退休計劃
View P-Fund Plan=檢視公積金計劃
View Payment Code=檢視支薪代號
View Payroll Formula=檢視支薪公式
View Payroll Group=檢視支薪組別
View Position Information=檢視職位資料
View Qualification=檢視學歷
View Recurring Payment=檢視定期支薪
View Spouse=檢視配偶資料
View Taxation Adjustment=檢視
View Taxation Company=檢視
View User=檢視
View User Group=檢視
Whether the employee has any share options granted by your company or any other corporation in respect of his employment with/office in your company that are not yet exercised, assigned or released=僱員/董事是否持有你或其他公司就其受僱而發給但未行使、轉讓或放棄的股份認購權
Whether the employee has been conditionally granted a share options prior to commencing to be employed in Hong Kong, which can be exercised after rendering services in Hong Kong=僱員是否在受僱於香港工作前，已獲有條件地授予股份認購權，規定他要在香港提了服務後才可行使這些認購權
Oversea concern yes no=僱員的全部或部分入息是否由海外公司在本港或海外支付
Whether the employee would return to Hong Kong=僱員會否回港
Year=年份
Year of Service less than=服務年資 &lt;
Year Return=年度
- Back -=返回
New=新增
Save=儲存
Delete=刪除
Search=搜尋
Reset=重設
Help=說明
Add=新增
Cancel=取消
Go=執行
Re-Calculate=重新計算
Terminate=離職
Generate Final Payment=製作最後工資
Undo=還原
Display=顯示
Process=處理
Generate Bank File=製作銀行檔案
Generate Bank File with Autopay List=製作銀行檔案及自動轉賬列表
Generate Autopay List=製作自動轉賬列表
Generate Autopay List (Excel)=製作自動轉賬列表 (Excel)
Generate=製作
- Payment Detail -=支薪詳情
- Place of Residence Detail -=住處詳情
Generate File=製作檔案
Generate Control List=製作紀錄核對表
Generate Report=製作報告
Print=列印
ACTIVE_STAFF=在職
Terminated=已離職
Hourly=每小時
Daily=每日
Once per payroll cycle=每支薪期一次
Month=月
Hong Kong=香港
Kowloon=九龍
New Territories=新界
Overseas=海外
Male=男
Female=女
Single=單身
Widowed=喪偶
Divorced=離婚
Separated=分居
Married=已婚
Autopay=自動轉賬
Cash=現金
Cheque=支票
Other=其他
Yes=是
No=否
brother=兄弟
brother-in-law=姊妹的丈夫
daughter=女兒
father=父親
father-in-law=岳父
friend=朋友
mother=母親
mother-in-law=岳母
other relative=其他親戚
sister=姐妹
sister-in-law=夫或妻的姊妹
son=兒子
January=一月
February=二月
March=三月
April=四月
May=五月
June=六月
July=七月
August=八月
September=九月
October=十月
November=十一月
December=十二月
Single/Widowed/Divorced/Separated=單身/喪偶/離婚/分居
Expatriate staff return to home country=海外職員返回袓國
Secondment=暫借
Emigration=移民
Reset Balance=重設結餘
Adjustment=調整
Update Terms=更新條款
Update=更新
Insert=插入
ERROR_DATE_FROM_OVERLAP=開始日不能重疊
ERROR_ACCOUNT_REQUIRED=必須輸入戶口號碼
ERROR_DATE_TO_TOO_EARLY=終結日不能早於開始日
ERROR_TERMINATION_RECORD_NOT_FOUND=找不到離職資料
ERROR_EMP_NOT_TRANSFERABLE=不能轉移此僱員
ERROR_EMP_TRANSFERRED_BEFORE=僱員已曾經轉移(編號: {0})
ERROR_CODE_USED_BY_EMPLOYEE={0} '{1}' 正被以下僱員使用
ERROR_CODE_IS_IN_USE={0} 正在使用中
ERROR_CODE_DUPLICATE=重覆的{0}. '{1}' 已經存在
ERROR_LEAVE_APP_OVERLAP=休假日不能跟以前的休假申請重疊
ERROR_POS_OVERLAP=生效日期不能與之前的生效日期重疊
ERROR_DAYS_TOO_LARGE=申請日數過大
ERROR_INVALID_HOUR=時間不正確
ERROR_LEAVE_APP_NOT_SAME_MTH=休假申請必須在同一個月內
ERROR_INCORRECT_PASSWORD=密碼不正確
ERROR_CONFIRM_PASSWORD=確認密碼與密碼不同
ERROR_INVALID_DOB=出生日期不正確
ERROR_ONE_PAYMENT_PER_PCODE=支薪代號不能重複使用
ERROR_LEAVE_ADJ_OVERLAP=修正的日期與之前的休假調整重疊
ERROR_PAY_EFF_DATE_OVERLAP=當支薪代號重複使用時生效日期不能重疊
ERROR_DUPLICATE_YEAR_SERVICE=年資已存在
ERROR_DIVIDER_NOT_ZERO=份母不能為零
ERROR_INVALID_START_DATE=開始日不正確
ERROR_INVALID_END_DATE=終結日不正確
ERROR_INVALID_PERIOD=開始日/終結日不正確
ERROR_REC_CND_NOT_SELECT=請選擇定期支薪或索償與扣減
ERROR_EMP_TYPE_NOT_SELECT=請選擇最少一個僱員種類
ERROR_INCORRECT_DATE_RANGE=日期範圍錯誤
ERROR_DATE_END_TOO_EARLY=終結日不能早於開始日
ERROR_PASSWORD_NOT_MATCH=密碼不相乎
Personal Information=個人資料
Spouse/Dependant=配偶/家屬
Qualification/Skills=學歷/技能
Current Status=現況
Pension History=職業供款計劃紀錄
Leave Applications & History=休假申請及紀錄
Employer Participation No.=僱主參與編號
% of Contribution=供款百分比
Occupational Retirement Schemes Ordinance=職業退休計劃
Taxation Place of Residence Detail=稅務住處詳情
Forfeiture=喪失
Entitled=應得
Reserved=預訂
Leave Balance Adjustment=休假結餘調整
ERROR_DELETE_EMP_PAYMENT_EXISTS=員工編號 {0} 已經有支薪. 拒絕刪除
PARAM_CODE_LOGIN_MAX_FAIL_COUNT=封鎖帳號失敗次數
PARAM_CODE_LEAVE_ENTITLE_CUT_OFF_BY_SERVICE_DATE=用服務開始日子的月/日為結算日
PARAM_CODE_LEAVE_ENTITLE_CUT_OFF_MONTH=默認結算月份
PARAM_CODE_LEAVE_ENTITLE_CUT_OFF_DAY=默認結算日
PARAM_CODE_USE_ORSO=允許使用公積金計劃(例如: 職業退休計劃)
PARAM_CODE_TAXATION_USE_CHINESE_NAME=提交中文姓名到稅務處(不建議)
PARAM_CODE_SMTP_SERVER_NAME=外送郵件傳送(SMTP)伺服器名稱
PARAM_CODE_SMTP_PORT=連接埠
Username=用戶名稱
LOGIN_MAIN_MESSAGE=請輸入用戶名稱及密碼
Payment Summary List=付款摘要列表
Rounding Rule=進位規則
Rollback Payroll Process=還原支薪程序
System Parameters Setup=系統參數設定
ERROR_ACTION_ABORT=動作終止!
SYSTEM_APP_VERSION=系統版本
SYSTEM_DB_VERSION=系統資料庫版本
RUNNING_DB_VERSION=正在執行中的資料庫版本
Year End Bonus Plan Setup=年終獎金計劃設定
Code Setup=代號設定
Introduction=序言
MPF Setup=強積金設定
Logout=登出
System Requirements=系統需求 
System Requirement=系統需求 
Generate MPF File=製作強積金檔案
Hide in Pay Slip=不顯示於支薪通知書
Year End Bonus Plan Search=搜尋年終獎金計劃
Year End Bonus Plan List=年終獎金計劃序列
Eligible After Probation=通過試用期適用
Position Capacity=職位 (於稅務表格顯示)
Age=年齡
YEB Plan=年終獎金計劃
Class Name=級別名稱
Adjust Type=調整類別
Year End Bonus Options=年終獎金計劃選項
Import=導入
Import Claims and Deductions=導入索償與扣減
Import Details=上載詳情
Upload=上載
Claims and Deduction=索償與扣減
Bank File Information=銀行檔案資料
HSBC MPF File Detail=香港匯豐銀行強積金檔案詳情
Payment Method=付款方式
Employer ID=僱主編號
Default Class Name=預設級別名稱
Login=登入
Cost Allocation=成本分配
CostCenter=成本中心
Cost Center Setup=成本中心設定
Cost Allocation Trial Run=成本分配試算
Cost Allocation Trial Run Adjustment=調整成本分配試算
Cost Allocation Confirmation=成本分配確認
Cost Allocation Export to Excel=成本分配試算表匯出
Round to=進位至
Round up=上捨入
Round down=下捨入
decimal place(s)=小數位
Monthly Average Wages=每月平均工資
First Authorization Group=第一批核組別
Second Authorization Group=第二批核組別
Eligible Period=適合週期
Pass code for rollback process=還原支薪程序密碼
Rollback to previous payroll cycle=還原至上一支薪週期
DELETE_GENERIC_JAVASCRIPT=刪除的項目不可能復原。\r\n確認刪除嗎?
ERROR_MPF_DATE_TO_TOO_EARLY=生效日期不能早於 2000-12-01.
ERROR_LEAVE_ALLOWANCE_SHOULD_BE_WAGES=假期津貼應該是薪酬
ERROR_LEAVE_ALLOWANCE_SHOULD_NOT_BE_WAGES=假期津貼不應該是薪酬
Attendance=考勤
Roster Code Setup=當值時間代號設定
Roster Code Search=當值時間代號搜尋
Roster Code List=當值時間代號列序
Roster Code=當值時間代號
Roster Type=當值時間種類
Work Time Period Setting=工作時間周期設定
Count Total Work Hour Only=總工作小時
In Time=上班時間
Out Time=下班時間
Grace In Time=上班時間寬限
Grace Out Time=下班時間寬限
Enable Meal Break=啓用用膳時間設定
Overtime Setting=超時工作設定
Enable Overtime=啓用超時工作設定
Miscellaneous=雜項
Cut Off time=截數時間
Working Day Unit=工作日單位
Daily Working Hour=每日工作小時
Attendance Formula Setup=考勤公式設定
Attendance Formula Search=考勤公式搜尋
Attendance Formula List=考勤公式序列 
Attendance Formula=考勤公式
Attendance Plan Setup=考勤計劃設定
Attendance Plan Search=考勤計劃搜尋
Attendance Plan List=考勤計劃序列 
Attendance Plan=考勤計劃
mins=分鐘
Overtime=超時工作
Overtime Formula=超時工作公式
Late=遲到
Late Formula=遲到公式
Bonus Condition=考勤獎金條件
Max Late Count=最多遲到次數
Max Early Leave Count=最多早退次數
Max Sick Leave taken with Medical Certifcate=最多有醫生紙病假次數
Max No Pay Leave=最多無薪假次數
Max Absent=最多缺席次數
Bonus Amount=獎金
Max Late (mins)=最多遲到(分鐘)
Max Early Leave (mins)=最多早退(分鐘)
Max Sick Leave taken without Medical Certifcate=最多沒有醫生紙病假次數
Max Injury Leave Taken=最多工傷休假次數
Display Sequence No.=顯示次序
Time Card No.=考勤卡號碼
For Employee Self Service=僱員自助服務專用
Company E-mail Address=公司電郵地址
Cost Center=成本中心
Rounding Rule for Employer Contribution=僱主供款進位規則
Rounding Rule for Employee Contribution=僱員供款進位規則
Cost Allocation Detail Export=導出成本分配詳情
Confirmed=已確認
Year/Month=年/月
Export=導出
Cost Allocation Summary Export=導出成本分配摘要
Export Roster Table=導出當值時間表
Import Roster Table=導入當值時間表
Import Time Card Records=導入拍卡紀錄
ColumnDelimiter=欄位定義符號
(Space)=(空格)
Field Column=欄位
Location=地點
Sequence=次序
Year Format=年份格式
Date Separator=日期分隔符號
Time Separator=時間分隔符號
Import Time Card Record=導入拍卡紀錄
Generate Attendance Record=製作考勤紀錄
Attendance Record Adjustment=調整考勤紀錄
Roster=當值時間
Work Start=開始工作時間
Meal Break Out=用膳外出時間
Meal Break In=用膳返回時間
Work End=結束工作時間
Late (mins)=遲到(分鐘)
Attendance Record Detail=考勤紀錄詳情
Early Leave (mins)=早退(分鐘)
Overtime (mins)=超時工作(分鐘)
Working Day(s)=工作日數
Working Hour(s)=工作小時
Absent=缺勤
Export Attendance Record=導出考勤紀錄
Export Attendance Records=導出考勤紀錄
Import Attendance Record=導入考勤紀錄
Import Attendance Records=導入考勤紀錄
Generate Attendance Payment=製作考勤工資
Audit Trail=審計追蹤
ESS Authorizer Setup=僱員自助服務批核人設定
Authorization Group Setup=批核組別設定
Assign Authorizer=批核人指定
Edit Year End Bonus Plan=編輯年終獎金計劃
Globally applied to all employee=應用於所有僱員
Reset Password=重設密碼
Contract No=合約號碼
For Payroll Calculation Only=支薪計算專用
Override Employer=不理會僱主計劃設定
Override Employee=不理會僱員計劃設定
Cost Center Code=成本中心代號
View Cost Center=檢視成本中心
Follow pre-defined payment method=請選擇以下方式支付
Default autopay bank account=預設自動轉賬戶口
Final Payment Options=最後工資選項
Daily Formula for AL Compensation=每日有薪年假補償公式
Payment Code for AL Compensation by Employer=有薪年假僱主補償支薪代號
Monthly payment formula for Payment In Lieu=代通知金公式 通知期以月為單位
Daily payment formula for Payment In Lieu=代通知金公式 通知期以日為單位
Payment Code for Payment In Lieu (Employer)=僱主代通知金支薪代號
Payment Code for Payment In Lieu (Employee)=僱員代通知金支薪代號
Monthly payment formula for Long Service Payment / Severance Payment=月薪僱員長期服務金/ 遣散費公式
Payment code for Long Service Payment=長期服務金支薪代號
Payment code for Severance Payment=遣散費支薪代號
Export Template=導出範本
Days Adjust=日數調整
No. of days count=已計算日數
Employee Salary List=僱員工資列表
Employee Bank Account List=僱員銀行戶口列表
Payroll Detail Report=支薪詳情報告
Payroll Summary Report=支薪摘要報告
System Information=系統資料
Test Email Function =電郵測試
Email Address=電郵地址
Send=傳送
Confirm Cost Allocation=確認成本分配
Field=欄位
Column=欄
Authorization Group=批核組別
Authorizer Setup=批核人設定
Authorization Group Code=批核組別代號
Authorizer List=批核人列序
EE Info=僱員資料
Leave Application=休假申請
Receive Other Group Alert=接收其他組別通知
INBOX_SUBJECT_DOB18=18歲提示 ({0} - {1})
INBOX_SUBJECT_DOB65=65歲提示 ({0} - {1})
INBOX_SUBJECT_DOB=生日提示 ({0} - {1})
PARAM_CODE_PAY_SLIP_HIDE_LEAVE_BALANCE=在支薪通知書中隱藏休假結餘
ERROR_INVALID_FILE=檔案不正確或沒有選擇任何檔案
Active=生效中
Inactive/Locked=無效/已鎖
Extra Information=額外資料
Work Permit/License=工作證/牌照
Document=文件
Permit Type=許可證類別
Document Type=文件類型
PARAM_CODE_PAYROLL_MAX_MONTHLY_LSPSP_AMOUNT=計算長期服務金/遣散費最大每月工資
PARAM_CODE_PAYROLL_MAX_TOTAL_LSPSP_AMOUNT=最大可獲得長期服務金/遣散費
UNIFORM_B=上圍/胸圍
UNIFORM_W=腰圍
UNIFORM_H=下圍/臀圍
Tools=工具
Inbox=收件匣
User Preference=用戶喜好設定
Private Message=私人信息
Inbox Message List=收件匣信息列表
Subject=主旨
Reminder=提示
Reminder Type=提示種類
Birthday Reminder=生日提示
Age of 18 Birthday Reminder=18歲生日提示
Age of 65 Birthday Reminder=65歲生日提示
Criteria=準則
Function=工能
Roster Client Setup=當值客戶設定
Roster Client Search=當值客戶搜尋
Roster Client List=當值客戶列序 
Export Employee Information=導出僱員資料
INBOX_SUBJECT_PROBATION=試用期提示 ({0} - {1})
INBOX_SUBJECT_TERMINATION=離職提示 ({0} - {1})
INBOX_SUBJECT_WORKPERMITEXPIRY=工作證到期提示 ({0} - {1})
UNREAD_MESSAGE_POPUP_MESSAGE=你有 {0} 個未讀訊息
NEW_MESSAGE_POPUP_MESSAGE=你有 {0} 個新訊息
MPF Termination Code Setup=強積金離職代號設定
MPF Termination Code Mapping=強積金離職代號配對
MPF Termination Code Search=強積金離職代號搜尋
MPF Cessation Reason List=強積金離職原因列序
MPF Scheme=強積金計劃
YEB Prorata=年終獎金按比例計算
ERROR_PASSWORD_SAME_AS_OLD_PASSWORD=新密碼不能與舊密碼相同
PARAM_CODE_DEFAULT_LANGUAGE=系統預設語言
PARAM_CODE_ESS_DEFAULT_LANGUAGE=員工自助服務系統預設語言
View Year End Bonus Plan=檢視獎金計劃設定
Prorata Method=按比例計算方式
Monthly=每月
Uniform Information=制服資料
View Work Permit/License=檢視工作證/牌照 
Edit Work Permit/License=編輯工作證/牌照 
Permit No.=許可證號碼
Issue Date=發出日期
Expiry=有效日期
Working Experience=工作經驗
Document List=文件序列 
Default Roster Code=預設當值時間代號
Default MPF Plan=預設強積金計劃
Percent=百分比
Edit Cost Center=編輯成本中心
Relevant Certificate=相關證明
Hour=時
Leave Code List=休假代號序列
Max. Brought Forward=最大帶假日數
Cessation Reason List=離職原因序列
Default Value=預設數值
Outgoing Email Address=外送電郵地址
SMTP Server=外送郵件傳送伺服器
Language=語言
Probation Reminder=試用期提示
Employee Termination Reminder=僱員離職提示
Work Permit Expiry Reminder=工作證到期日提示
Cost Allocation Adjustment=調整成本分配
Cost Allocation Detail=成本分配詳情
Roster Client=當值客戶
Roster Client Site=當值客戶地點
Property Name=物業名稱
Nature of Premises=物業性質
In Charge=負責人
Contact No=聯絡號碼
Service Hours=服務日間
Shift=輪班
Client Name=客戶名稱
Site=地點
Meal Break Start Time=用膳開始時間
Meal Break End Time=用膳結束時間
OT Start Time=超時工作開始時間
OT End Time=超時工作結束時間
Count OT from Out Time=由離開時間開始計算超時工作
OT Unit=超時工作計算單位
Override Hourly Rate=不理會預設時薪
New Hourly Rate=新的時薪
Deduct Working Hour for Meal Break=扣減用膳時間
Overtime Ratio=超時工作比率
No Of Hour=小時
Rate=比率
View Roster Code=檢視當值時間代號
View Attendance Formula=檢視考勤公式
Formula for Daily Prorata=計算日薪公式
Formula for Hourly prorata=計算時薪公式
Use Payroll Formula=採用支薪公式
Fix Hourly Rate=固定時薪
Work hour per day=每日工作時數
Daily Payment/ Work hour per day=日薪/ 每日工作時數
per hour=每小時
Include Early Leave=包括早退
Max Sick Leave taken with Relevant Certificate=最多病假次數(有相關證明)
Max Sick Leave taken without Relevant Certificate=最多病假次數(沒有相關證明)
Recalculate=重新計算
Has Bonus=有獎金
By Attendance Plan=根據考勤計劃
Employee Salary Report=僱員工資列表
Employee Year of Service List=僱員服務年資列表
Employee Year of Service Report=僱員服務年資列表
Employee Bank Account Report=僱員銀行戶口列表
Parameter=參數
Not Selected=未選擇
Confirmed Date =確認日期
Confirmed By =確認用戶
Edit Working Experience=編輯工作經驗
View Working Experiencet=檢視工作經驗
Switch Display Mode=切換顯示模式
Payroll Process Cycle=支薪處理周期
Edit Document=編輯文件
View Document=檢視文件
File name=檔案名稱
Emergency Contact=緊急聯絡資料
View EmergencyContact=檢視緊急聯絡資料
Edit EmergencyContact=編輯緊急聯絡資料
Phone No. (Day)=聯絡號碼 (日間)
Phone No. (Night)=聯絡號碼 (夜間)
Retrive data from last information=讀取舊資料
Export to Excel=匯出成Excel文件
Export to Word=匯出成Word文件
FUNCTION_SYS000=系統參數設定
FUNCTION_SYS001=公司設定
FUNCTION_SYS002=公司架構設定
FUNCTION_SYS003=商業層級設定
FUNCTION_SYS004=支薪代號設定
FUNCTION_SYS005=雜項代號設定
FUNCTION_SYS006=假期設定
FUNCTION_SYS007=年終獎金計劃設定
FUNCTION_SYS008=審計追蹤
FUNCTION_SYS009=工作時間組合設定
FUNCTION_SYS999=審計追蹤
FUNCTION_SEC001=用戶設定
FUNCTION_SEC002=用戶組別設定
FUNCTION_SEC003=批核組別設定
FUNCTION_SEC004=批核人設定
FUNCTION_PER001=僱員個人資料
FUNCTION_PER002=僱員銀行戶口資料
FUNCTION_PER003=僱員配偶/家屬資料
FUNCTION_PER004=僱員學歷/技能
FUNCTION_PER005=僱員住處資料
FUNCTION_PER006=僱員合約資料
FUNCTION_PER007=僱員職位紀錄
FUNCTION_PER007-1=僱員定期支薪記錄
FUNCTION_PER008=僱員職業供款計劃紀錄
FUNCTION_PER009=僱員休假申請及查詢休假紀錄
FUNCTION_PER010=僱員休假結餘
FUNCTION_PER011=僱員終止僱用
FUNCTION_PER012=僱員成本中心
FUNCTION_PER013=僱員工作證/牌照資料
FUNCTION_PER014=僱員文件資料
FUNCTION_PER015=僱員緊急聯絡資料
FUNCTION_PER016=僱員工作經驗
FUNCTION_PER017=僱員工傷記錄
FUNCTION_PER018=僱員獲取補假記錄
FUNCTION_PER019=僱員編更表組別
FUNCTION_PER900=導出僱員資料
FUNCTION_LEV001=休假類別設定
FUNCTION_LEV002=休假代號設定
FUNCTION_LEV003=休假計劃設定
FUNCTION_PAY001=支薪組別設定
FUNCTION_PAY002=支薪公式設定
FUNCTION_PAY003=索償與扣減
FUNCTION_PAY004=支薪試算
FUNCTION_PAY005=調整支薪試算
FUNCTION_PAY006=還原支薪試算
FUNCTION_PAY007=支薪確認
FUNCTION_PAY008=結束支薪程序
FUNCTION_PAY009=過往支薪紀錄查詢及調整
FUNCTION_PAY010=製作銀行檔案
FUNCTION_PAY011=製作強積金檔案
FUNCTION_PAY900=還原支薪程序
FUNCTION_MPF001=強積金計劃設定
FUNCTION_MPF002=強積金參數設定
FUNCTION_MPF003=自願性供款計劃設定
FUNCTION_MPF004=公積金計劃設定
FUNCTION_MPF005=強積金離職代號設定
FUNCTION_CST001=成本分配試算
FUNCTION_CST002=調整成本分配試算
FUNCTION_CST003=確認成本分配
FUNCTION_CST004=導出成本分配詳情
FUNCTION_CST005=導出成本分配摘要
FUNCTION_ATT001=當值時間代號設定
FUNCTION_ATT002=考勤公式設定
FUNCTION_ATT003=考勤計劃設定
FUNCTION_ATT004=導出當值時間表
FUNCTION_ATT005=導入當值時間表
FUNCTION_ATT006=導入拍卡紀錄
FUNCTION_ATT007=製作考勤紀錄
FUNCTION_ATT008=調整考勤紀錄
FUNCTION_ATT009=導出考勤紀錄
FUNCTION_ATT010=導入考勤紀錄
FUNCTION_ATT011=製作考勤工資
FUNCTION_ATT012=當值客戶設定
FUNCTION_TAX001=稅務公司設定
FUNCTION_TAX002=稅務種類配對
FUNCTION_TAX003=製作稅務記錄
FUNCTION_TAX004=稅務調整
FUNCTION_TAX005=製作稅務磁碟
FUNCTION_RPT001=僱員報告
FUNCTION_RPT002=支薪及強積金報告
FUNCTION_RPT003=稅務報告
ERROR_HKID_PASSPORT_REQUIRED=必需輸入香港身分證號碼或護照號碼
ERROR_HKID_PASSPORTCOUNTRY_REQUIRED=必需輸入香港身分證號碼或護照號碼連發證國家
ERROR_INVALID_VALUE_DATE=過賬日不正確
ERROR_TOTAL_PERCENTAGE_NOT_100=總百分比必須要100%
ERROR_LEAVE_APP_TIME_OVERLAP=休假時間不能跟以前的休假申請重疊
Re-join=重新入職
REJOIN_TERMINATED_EE_JAVASCRIPT="重新入職" 動作會刪除所有離職資料, 但會保留已支付的最後工資資料.\r\n還要繼續嗎?
ERROR_NUMBR_RANGE=數字必需在 {0} 和 {1} 之間
MAX_COMPANY=最多可用公司數目
MAX_USERS=最多可用用家數目
TRIAL_PERIOD_TO=測試版本限期至
ENTER_AUTHORIZATION_CODE=輸入驗證碼
EELEAVEAPP=假期申請
EEPROFILE=個人資料
EELEAVECANCEL=取消假期申請
EEOTCLAIM=補假申請
EEOTCLAIMCANCEL=取消補假申請
USRSUBMIT=已遞交
USRCANCEL=取消申請
1STAPPROVED=初步申請認可
APPROVED=申請認可
1STREJECTED=第一批核者拒絕
2NDREJECTED=第二批核者拒絕
Show Advanced Options=顯示進階選項
Hide Advanced Options=隱藏進階選項
Training=訓練
Training Record=訓練記錄
Training Seminar Setup=訓練課程設定
Training Report=訓練報表
Training Seminar Search=訓練課程搜尋
Training Seminar Detail=訓練課程資料
Training Seminar List=訓練課程列表
Training Course=訓練科目
Trainer=導師
Training Date=訓練日期
Duration=需要時間
View Training Seminar=檢視訓練課程
Edit Training Seminar=編輯訓練課程
Enroll Training Seminar=登記訓練課程
Enroll=登記
Remove=移除
PARAM_CODE_DEFAULT_RECORDS_PER_PAGE=每頁顯示記錄
PARAM_CODE_MPF_FILE_BOCI_ENCRYPT_PATH=中銀保誠加密程式的完整路徑
PARAM_CODE_DOCUMENT_UPLOAD_FOLDER=上載文件的完整路徑
PARAM_CODE_DB_TITLE=資料庫標題 (用作識別資料庫，例如：UAT)
Emp. No.=僱員編號
Emp. Name=僱員名稱
Mobile=手提電話號碼
Email=私人電郵地址
Residential Addr=住址
Correspondence Addr=通訊地址
Is Wages:=是否工資:
Phone No (Day)=聯絡電話(日間)
Phone No (Night)=聯絡電話(夜間)
Upload File=上載檔案
Date of Join=入職日期
Employee ID=僱員編號
Job Position=職位
Date Join=入職日期
Date Left=最後工作日期
Year of Service=服務年資
Year of Service List=僱員服務年資列表
As of=直至
Bank Name=銀行名稱
A/C No=戶口號碼
Employee Detail Report=僱員詳情報告
Basic Information=基本資料
As Of Date (Current)=現在日期 (現在)
Reference Date (Previous)=參考日期 (上一個) 
Hierarchy=層級
New Join=新入職
Transfer In=轉入
Transfer Out=轉出
Turnover=員工流動
Employee Gender Report=僱員性別報告
Employee Residency Report=僱員住處報告
Employee Birthday List=僱員生日列表
Employee Leave Application List=僱員休假申請列表
Leave Balance List=休假結餘列表
Employee ESS Request Report=僱員自助服務未批核申請報告
Net Payment Report by Payment Method=淨薪金報告(以付款方式列出)
Payment Allocation Report=薪金配置報告
Employee No.=僱員編號
Emp Name=僱員名稱
Business Group=商業組別
Termination Code=離職原因
Employe Name=僱員名稱
Days=日數
Relevant Certificate?=相關證明?
Entitlement=應得
Emp No:=僱員編號:
Name:=僱員名稱:
Applications=申請
No. of Day(s) Taken=已取日數
Entitle=應得
Submit Date/Time=遞交日期/時間
Submit Type=遞交類別
Recurring Payments=定期支薪記錄 
Bank Accounts=銀行戶口 
Account No.=戶口號碼
Bank Account Name=戶口持有人
Issues by:=簽發國家
ESS Authorization Group Setup=僱員自助服務批核組別設定
Annual Leave Prorata Rounding Rule Setup=年假按比例計算進位規則設定
Annual Leave Prorata Rounding Rule Search=搜尋年假按比例計算進位規則
Rounding Rule List=進位規則列表
View Annual Leave Prorata Rounding Rule=檢視年假按比例計算進位規則
Annual Leave Prorata Rounding Rule=年假按比例計算進位規則
Calculate Statutory Holiday on next month=於下一個月計算法定假期
Statutory Holiday Options=法定假期選項
Compare previous leave plan enrolled=比較以前休假計劃
Do not include Feb 29 when calculating prorata=不要將2月29日加入按比例計算
Reset Year of Service When Changed Employee Leave Plan=當僱員轉換休假計劃重新計算服務年資
Do not count first incomplete year of service=不要計算第一年不完整服務年資
Leave Plan Rank Level=休假計劃等級
The setting "Compare previous leave plan enrolled" is required=需與"比較以前休假計劃"一併使用
Use Business Internet Banking Service (max. 200 transaction per file)=使用商務網上理財 (每個檔案最多包含200個交易)
Payment Code for multiple bank file=輸入支薪代號以製作多個銀行檔案
(press ENTER to separate each payment code=(按ENTER以分隔不同支薪代號)
Previous Value Date=過賬日
Others=其他
Emp No.=僱員編號
End Of Report=報告結束
Birthday Range=生日範圍
Display Year of Birth=顯示出生年份
HK ID=香港身份證號碼
Remarks=備註
Issued By=簽發國家
Difference=相差
Process Month/Year=處理月份/年份
Reference Month/Year=參考月份/年份
Reference Month=參考月份
Specified Date=指定日期
Wages From=工資開始日
Wages To=工資結束日
Total Wages=工資總額
Total OT Income=超時工資總收入
Total Exclude Wages=不予計算工資
Include OT Income?=包含超時工資
Total Work Days=總工作日數
Total Days Exclude=不予計算日數
Daily Average Wages=每日平均工資
Report Period=報告期
Payment code description=支薪代號描述
MPF Contribution Detail=強積金供款詳情
Relevant Income=有關入息
Mandatory Contribution=強積金供款
Voluntary Contribution=自願性供款
Total Contribution=供款總額
MPF Date=強積金日期
Chinese=中文姓名
Emp.Seq=僱員編號
Emp.Name=僱員名稱
Contribution=供款
Net Income=淨收入
Net Payments Group by Pay Method=淨收入以支薪方式分類
Payroll History Information=過往支薪紀錄
Country of Issue=簽發國家
ESS Pending Request Report=僱員自助服務未批核申請報告
ERROR_CND_IMPORT_BATCH_PAYROLL_PROCESSING=由於以下員工正在執行支薪程序, 還原匯入失敗 :
ERROR_NO_RECORD_IMPORT=沒有紀錄可以匯入
ERROR_SUPER_USER_REQUIRED=系統最少要有一個用戶可以存取 用戶組別設定 或 用戶設定.
Import History=過往導入紀錄
Outstanding Records=待處理紀錄
History Records=過往紀錄
Companies=公司
Calculate Working Hours/Days by half if total working hours is smaller than=將工作時數/日數減半, 如工作時數小於
Injury Record=工傷紀錄
Accident Date=意外發生日期
Injury Nature=損傷性質
Date of Accident=意外發生日期
Nature of Injury=損傷性質
Location of Accident=意外發生地點
Reason for Accident=意外發生的原因
Date of Report=報工傷日期
Cheque Received Date=收票日期
Settle Date=完結日期
Bonus Amount for Overtime (per hour)=超時工作獎金(每小時)
Overtime start at=超時工作在正常工作時間完結後
min(s) after the end of normal working hours=分鐘開紿
Total Income=總收入
Pay Slip=支薪通知書
No. of Records:=紀錄數目:
Group by Hierarchy Level :=以公司架構分類:
Provident Fund Statement=公積金報告
Contribution Period=供款期
ERROR_DATE_TOO_EARLY=日期不能早過入職日期
ERROR_DATE_TOO_LATE=日期不能遲過最後工作日期
LEAVEAPP_FORCE_DELETE_JAVASCRIPT=假期申請已經用作支薪計算\r\n你必須手動調整支薪紀錄\r\n你確定要刪除嗎? 
LEAVEAPP_FORCE_EDIT_JAVASCRIPT=假期申請已經用作支薪計算\r\n你必須手動調整支薪紀錄\r\n你確定要儲存嗎?
Check E-mail Log =查閱電郵記錄
Updated Successful=更新成功
Public Holiday Setup=公眾假期設定
Public Holiday Year=公眾假期年份
Update Holiday Table by File=以導入檔案更新假期表
Set Paid Date=支付日期紀錄
Set paid date to=設定支付日期至
Paid Date=支付日期
Force Edit=強行更改
Force Delete=強行刪除
PARAM_CODE_PAY_SLIP_HIDE_MINIMUM_WAGE_INFO=在支薪通知書中隱藏最低工資的資訊
Do not deduct Voluntary contribution being contributed to mandatory contribution=如已供強積金供款, 該部份不要計算自願性供款
The setting "Do not deduct MPF Only payment being contribute" under AVC Plan Setting is required=The setting "Do not deduct MPF Only payment being contribute" under AVC Plan Setting is required
Ceiling Amount=最大限額
Contributed after MPF Only=Contributed after MPF Only
Payment Setting=供款設定
Work Hour Pattern Setup=工作時間模式設定
Work Hour Pattern Search=工作時間模式搜尋
Work Hour Pattern List=工作時間模式序列
Working hour determine method=計算工作時數方法
Default Working hour per day=預設每日工作時數
Default meal break hour per day=預設每日用膳時間
Sunday=星期日
Monday=星期一
Tuesday=星期二
Wednesday=星期三
Thursday=星期四
Friday=星期五
Saturday=星期六
Use Public Holiday Table=使用公眾假期表
Use Statutory Holiday Table=使用法定假期表
Use Roster Table=使用當值時間表
Manual Input=自訂
Override Minimum Wage=不理會最低工資
New Minimun Hourly Rate=新最低工時
Work Hour Pattern=工作時間模式
Total Number of Days=總日數
Work Injury Record=工傷記錄
Rejoin with new Emp No.=用新僱員編號重新加入
Rest Payment=休息款項
Training Seminar Enroll List=訓練課程登記序列 
Sort By=排序
Training Seminar Period=訓練課程時期
TrainingCourse=訓練課程
Function List=功能表
Include Employee Name, Company, Hierarchy and Position on every sheet (except Employee Personal Information) =包含僱員名稱, 公司,公司架構及職位於所有工作表 (僱員個人資料除外) 
Decimal Place(s) for Leave Balance Display=顯示休假結餘小數位
Use Work Hour Pattern=使用工作時間模式
Skip Public Holiday Checking=略過公眾假期檢查
Skip Statutory Holiday Checking=略過法定假期檢查
Statutory Minimum Wage Setup=法定最低工資設定
Employee Working Summary=僱員工作摘要
List=序列
Import Employee Working Summary=導入僱員工作摘要
Hourly Rate=時薪
Export Employee Working Summary=導出僱員工作摘要
Export Employee Working Summary Template=導出僱員工作摘要範本
Import Date=導入日期
Uploaded by=上載人
Stop Payment=停止付款
Claims and Deductions Import History=索償與扣減導入紀錄
Trial Run Date=試算日期
Trial Run By=試算人
Generate AutoPayList (Excel)=製作自動轉賬列表 (試算表)
Direct Debit=直接入賬
Re-activate Payroll Process=重新啟動支薪程序
Pass code for Re-activate=重新啟動支薪周期密碼
Re-activate=重新啟動
Re-activate Payroll Cycle=重新啟動支薪周期
Hierarchy Level Mapping to Site Code=當值地點公司架構配對
Roster Client Site Setup=當值客戶地點設定
Meal Break Time (mins)=用膳時間(分鐘)
Meal Break Unit=用膳時間計算單位
hour(s)=小時
Daily Payment=日薪
No Rounding=不進位
File has header=有檔案標題
No time card records=沒有拍卡紀錄
Print Mapping List=製作配對列表
Payment not mapped to any taxation payment=沒有配對於稅務類別的支薪代號
PARAM_CODE_SESSION_TIMEOUT =閒置超時 (分鐘)
Keep Connected=保持連線
Remind Day(s) Before =發生日前提醒
Remind Day(s) After =發生日後提醒
A.M.=上午 
P.M.=下午 
Active / Will be terminated=在職 / 即將離職
Will be terminated / Terminated=即將離職 / 已離職 
(none)=(無)
Close=關閉
Select All=選擇所有
Unselect All=取消選擇所有
More=更多
All=全部
Non-payroll Item=非支薪項目
Compensation Leave Entitlement=補假獲得
Hours Claim=索取時間
Approved By=批核者
Compensation Leave Entitlement History=補假獲得記錄
Display All Records=顯示所有記錄
Display Latest Record(s) Only=只顯示最近記錄
Import Employee Information=導入員工資料
Import Leave Balance Adjustment=導入休假結餘調整
Active Company=現有公司
Active Users=現有用戶
Average Basic Salary=平均基本薪酬
Copyright=版權
New Emp. No=新員工編號
Password for ZIP file=ZIP檔案的密碼
Previous Emp. No.=上一個員工編號
Recurring Basic Salary=定期支付的基本薪酬
Ver. =版本
English Name=英文姓名
Net Payment=淨薪金
Non-Relevant Income=非有關入息
Wages Payable for Min Wages=最低工資條例下須支付的工資
Total Hours Worked=總工時
Min Wages Required=法例要求的最低工資
Employer Mandatory Contribution=僱主強積金供款
Employer Voluntary Contribution=僱主自願性供款
Employer P-Fund Contribution=僱主公積金供款
Total Employer Contribution=僱主總供款
Total Employee Contribution=僱員總供款
Total Taxable Payment=總課稅額
Total Non-Taxable Payment=總非課稅額
Amount (HK$)=款額(港元)
Date of Bank File Generated=銀行檔案製作日期
Use Common Leave Year=使用共同假期年
Common Leave Year Start Date=共同假期年開始日期
Year of Service Calculation Method=年資計算方式
Rest Day Options=休息日選項
Enable Statutory Holiday Entitlement in Employee Leave Balance=在休假結餘裡啟用法定假期日數獲取
Enable Rest Day Entitlement in Employee Leave Balance=在休假結餘裡啟用休息日日數獲取
Number of Rest Day Entitled=休息日獲得日數
day(s)=日
per month=每月
per week=每星期
Week to gain Rest Day for Weekly Entilement=休息日獲得的星期
Number of day for prorata calculation=按比例計算時用的基礎日數
Forfeit Last Year BF Record=喪失上年度的帶假記錄
Final Payment Statement=最後工資結算表
FINAL PAYMENT STATEMENT REPORT=最後工資結算表
Statutory Minimum Wage Summary Report=法定最低工資報表
Long Service Payment / Severance Payment Estimation List =長期服務金 / 遣散費預算表
Employee Compensation Leave Entitlement=員工補假獲取
Roster Table Overview=編更表概要
Roster Table Group Setup=編更表組別設定
Generate Compensation Leave Entitlement=制作補假獲取
Training Seminar Enroll=訓練課程登記
Training Course Setup=訓練科目設定
Employee Self Service=員工自助服務
Default Language=預設語言
Update Employee Information=更新員工資料
Roster Table=編更表
Employee Reports=員工報告
Payroll & MPF Reports=支薪及強積金報告
Taxation Reports=稅務報告
--- Show All Functions ---=--- 顯示所有功能 ---
Apply on first year brought forward only=只適用於第一年帶假
Determined by Date of Join=以入職日期來計算出來
Show all bank account =顯示所有銀行戶口
Press &quotCtrl&quot for multiple selection=請按著"Ctrl"鍵來選擇多個項目
Users=用戶
Emp No. (if any)=員工編號(如有)
Show Header Only =只顯示標題
Show header without data update=顯示沒有任何更改記錄的標題
Show Internal ID Only (Without Item Description)=只顯示系統內部用的識別編號(不會提供任何描述)
Notice Date of Termination=離職通知日期
Expected Last Employment Date=預計最後工作日期
Actual Last Employment Date=實際最後工作日期
Default Bank Account=預設的銀行戶口
Invalid User Name or Password=用戶名稱或密碼不正確
Account is Inactive/Locked=帳號已經無效/被鎖
Account is Locked=帳號已經被鎖
Use Payment Code for Leave Allowance as Deduction Code if net payment is $0=當淨款額為$0時以 "休假津貼的支薪代號" 作為扣減代號
Skip Payroll Process=不作支薪計算
Payroll Process on Next Month=下一個月才作支薪計算
Hide in ESS=在員工自助服務中隱藏
ERROR_BANKFILE_NEGATIVE=銀行檔案不應該包含負數
Taxation Generated Before=已完成稅務製作
ERROR_NO_EMPLOYEE_SELECTED=沒有選擇員工
Learning Method=學習方式
Default Cost Center=預設的成本中心
Distance Learning=遙距學習
On-Campus=校內
Check Every Year=每年檢查
Exclude first 3 month probation period=不包括試用期首3個月
View Work Hour Pattern=檢視工作時間模式
Edit Work Hour Pattern=編輯工作時間模式
Relevance Experience=相關經驗
Roster Table Group=更表組別
View Work Injury Record=檢視工傷記錄
Use Existing Formula=使用現有公式
Copy=複製
Rest day with pay=有薪休息日
Meal break with pay=有薪用膳時間
Additional Remuneration=額外報酬
Total Working Hours=總工作時數
Total Wages for Minimum Wages=以最低工資條例計算的總工資
Minimum Wages Required=須支付的最低工資
Working Hours Count for this payroll Section=此支薪程序的工作時數
Year End Bonus=年終獎金
Roster Table Group Search=編更表組別搜尋
Roster Table Group List=編更表組別序列
View Roster Table Group=檢視編更表組別
Save Settings=儲存設定
Import to Claims and Deductions=導入至索償與扣減
Sub-Scheme No.=附屬計劃編號
Group No.=團體號碼
Sub-group No.=附屬團體號碼
Color Code=色碼
Ignore -ve sign when rounding=當進位不理會正負號
Day Unit=工作日單位
Working hour per day=每日工作時數
Meal break hour per day=每日用膳時數
Auto Fill=自動填寫
Supervisor=管理人
View Compensation Leave Entitlement=檢視補假獲得
No. of Hours Claim=索取時數
Claim Time=索取時間
Claim Period=索取周期
Adjust Value=調整數值
Payment Code for AL Compensation by Employee=有薪年假僱員補償支薪代號
Payment Code for Rest Day Compensation=休息日補償支薪代號
Payment Code for Statutory Holiday Compensation=法定假期補償支薪代號
Minimum period of employment for AL Compensation=有薪年假的最少僱用期
Daily Formula for Rest Day Compensation=每日休息日補償公式
Daily Formula for Statutory Holiday Compensation=每日法定假期補償公式
Default Prorata Formula=按比例計算預設公式
Rest Day Prorata Formula=休息日按比例計算公式
Payment Code for Additional Remuneration (for Statutory Minimum Wage)=(法定最低工資)額外報酬的支薪代號
Meal Break Duration=用膳時數
Minimum Working Hour for Meal Break=獲得用膳時間的最少工作時數
Partial Bonus Condition=部份考勤獎金條件
Gain as Compensation Leave Entitlement=以補假換取
Payroll Prorata Formula for Absent=缺席按比例計算公式
Compensated late/early leave by Overtime=以超時工作抵消遲到/早退
Payment Code for Bonus Payment=考勤獎金的支薪代號
Percentage of Bonus=考勤獎金的百分比
Prorata for New Join Employees=新入職僱員按比例計算
Prorata for Terminated Employees=離職僱員按比例計算
Entitle bonus for terminated employee worked with incompleted month=離職僱員在不完整月應獲得考勤獎金
Auto E-mail Audit Trail=自動寄出審計追蹤
E-mail Address=電郵地址
Separate address with ENTER=換行分隔地址
Prorata on Claims and Deductions=按比例計算索償與扣減的金額
View=檢視
Check every leave year for prorata of Annual Leave=檢查每一個假期年的年假按比例計算
Comparison between formula=公式比較
Comparison between result =結果比較
Use Claims and Deduction for Daily/Hourly Recurring Payment=每日/每小時的定期支薪以索償與扣減資料計算
Payroll trial run process is completed =支薪試算完成
Payroll trial run is processing=支薪試算進行中
Undo Successful=還原支薪試算完成
Complete=完成
Stop Payment Successful=停止付款完成
Paid Date is updated=支付日期已更新
Are you sure to end this payroll process?=是否確定結束此支薪程序? 
Are you sure to rollback to previous payroll process?=是否確定還原支薪程序? 
ARE_YOU_SURE_TO_CONFIRM="是否確定?";
Rollback Complete=還原支薪程序完成
Late/Early Leave Setting=遲到/早退設定
Late Unit=遲到單位
Meal Break Late Unit=用膳時間遲到單位
Early Leave Unit=早退單位
Meal Break Early Leave Unit=用膳時間早退單位
Included Meal Break Early Leave=包括用膳早退
Included Meal Break Late=包括用膳遲到
Include Meal Break Early Leave=包括用膳早退
Include Meal Break Late=包括用膳遲到
OT Rate and Override Hourly Rate will not take effect=不理會超時工作比率及新時薪設定
Override Amount from Recurring Payment =不理會定期支薪款額
Roster Client Site List=當值客戶地點列序
Attendance Record Generation is completed=製作考勤紀錄完成
Import Sucessful=導入成功
Taxation records are generating…=稅務記錄製作中…
Taxation records are generated successfully=稅務記錄製作完成
Message for Relevant Certificate Alert=相關證明提示訊息
Authorization Group Search=批核組別搜尋
Authorization Group Detail=批核組別詳情
MPF Termination Code=強積金離職代號
Unlimited=無限
PRODUCT_TYPE=產品類型
MAX_EMPLOYEES=最多現職員工數目
Active Employees=現職員工
Message for Relevant Certificate Alert:=相關證明提示訊息:
ERROR_MAX_LICENSE_LIMITCH_REACH=已經達到最大許可限制 ({0})! 動作終止!
Skip MPF calculation if recurring payment calculation does not exist =如果未有計算定期支薪，略過強積金計算
(keep empty if Overtime start immediately)=(保持空白如超時工作立即生效)
(keep empty if Overtime do not have limit)=(保持空白如沒有超時工作上限)
Include OT at Meal Break=超時工作計算包含用膳時間
Include Meal Break Overtime=包括用膳時超時工作
Meal Break Late (mins)=用膳遲到(分鐘)
Meal Break Early Leave (mins)=用膳早退(分鐘)
Meal Break Overtime (mins)=用膳超時工作(分鐘)
Recalculate result from IN/OUT record=以開始/結束工作時間重新計算結果
Location Mapping=工作地點配對
Location Name=工作地點名稱
Mapped to=配對至
Roster Time Override=新當值時間
Actual=拍卡時間
PAYROLL_UNDO_CLICK_MESSAGE=確認要還原這個大量導入嗎?
New Join Employee List=新入職員工列表
Employee Probation List=員工試用期列表
Imported by=導入者
Scheme Name=計劃名稱
Next Sequence No.=下一個序號
Employer Plan No=僱主計劃編號
Employee Filter =僱員過濾器
Do NOT apply rounding rule while calculating balance of Annual Leave=在計算年假結餘時不要使用進位規則
REPORT_GENERATING_TO_INBOX=報表正在製作中 ，請稍後檢查收件匣。
First Hierarchy Level Display=第一個商業層級顯示為
Second Hierarchy Level Display=第二個商業層級顯示為
Refresh=重新整理
Attachment=附件
This amount must also be included in details of income paid or payable=此款額必須包括在詳細入息內
Prorata Formula Options=按比例計算公式選項 
Rest Day=休息日
Change of Payroll Group or Recurring Payment=更改支薪組別或定期支薪
Skip Statutory Holiday Calculation=略過法定假期計算
Default Formula=預設公式
ERROR_SAAS_FILE_SUBMIT_AFTER_CUTOFF=檔案遞交服務已經於 {0} 後停止服務, 請於明天 {0} 前再嘗試
PRODUCT_TRIAL_WILL_EXPIRE=試用期將於 {0} 天後完結.
ERROR_FIELD_REQUIRED={0} 是必須的
ERROR_DATE_FORMAT=日期格式錯誤 !
MESSAGE_COST_CENTER_NOT_FOUND=員工 ({0}) 的成本中心尚未設定.
ERROR_AVCPLAN_CEILING_NOT_NUMERIC={0} 的最大限額不是數字
ERROR_COSTCENTER_PERECNTAGE_NOT_NUMERIC={0} 的成本中心百分斗率不是數字
ERROR_REMINDER_DAYS_NOT_NUMERIC={0} 的日數不是數字
Rest Day Entitled=應得休息日
Rest Day Taken=已取休息日
Total Working Day(s)=總工作日數
Total Hours for Meal Break=總用膳時數
ERROR_SURNAME_CONTAIN_SPACE=姓氏不可以有空白格
ALERT_NEW_STAFF_NO_BEEN_USED=僱員編號{0}已經被其他員工使用，已經賦予了新的僱員編號{1}。
BANKFILE_CONSOLIDATION_MESSAGE=上載支薪/強積金檔案的截數時間為星期一至星期六下午5:00正(公眾假期除外)。
BANKFILE_CLEARING_MESSAGE=因銀行五天結算, 轉賬服務只會在星期一至星期五進行(公眾假期除外)
BANKFILE_REPORT_STORE_PERIOD_MESSAGE=所有銀行訊息只供儲存90天，之後將會被自動刪除 。請於收取訊息後，下載所有的報告以供備存。
e-Channel=電子渠道
Submit Autopay File=遞交自動轉賬檔案
Submit MPF Contribution File=遞交強積金檔案
Notification=通告
Registered Bank Payment Code=已登記的銀行轉賬代號
Bank Payment Code=銀行轉賬代號
Consolidate Date=收集日期
Transaction Reference=交易參考編號
Autopay In/Out=自動入賬/支賬
Date Received=收取日期
Total Size=總用量
Confirm By:=確認人:
Message Detail=信息詳情
Submit via e-Channel=經由電子渠道遞交
Employment Type Code Setup=僱用型式代號設定
Cessation Reason Code Setup=離職原因代號設定
Position Code Setup=職位代號設定
Qualification Code Setup=學歷代號設定
Skill Code Setup=技能代號設定
Skill Level Code Setup=技能級別代號設定
Rank Code Setup=階級代號設定
Staff Type Code Setup=職員種類代號設定
Release Pay Slip to ESS=發放支薪通知書到僱員自助系統
e-channel Notification=電子渠道通告
Modify user accounts with less permission only=只能變更較低等級用戶
Show Key ID Only=只顯示內部索引
Prepared by=製作人
Reviewed by=驗證人
Skip Deduction=略過扣減計算
Applicable only if deduction formula and allowance formula is different=只適用於不同的扣減與津貼公式
Permit Type Code Setup=許可證類別代號設定
Document Type Code Setup=文件類別代號設定
Cost Center Code Setup=成本中心代號設定
OK=確定
Calculate as daily=以日薪方式計算
Prorata Formula=按比例計算公式
Company Bank Account Setup=公司銀行戶口設定
Bank Account List=銀行戶口列表
View Company bank Account=檢視公司銀行戶口
Company bank Account=公司銀行戶口
Business Hierarchy=商業層級
Sub-Total=小計
Last Working Date=最後工作日期
Effective Date of Termination=離職生效日期
Reason for Termination=離職原因
EMPLOYEE DETAILS=僱員資料
Employee's Name=僱員姓名
Staff No.=僱員編號
ID No.=身份證號碼
Job Title=職位
Date Joined=入職日期
Current Salary=現有薪金
TERMINATION DETAILS:=離職資料:
Employee's Signature=僱員簽署
I, \n{EmpInfo.EmpName}\n hereby accept & confirm the above payment as the final settlement from \n{EmpInfo.CompanyName}\n and further confirm that I have no other claims against \n{EmpInfo.CompanyName}\n and its affiliates.=我 \n{EmpInfo.EmpName}\n 在此接受並確認上述款額為\n{EmpInfo.CompanyName}\n 的最終結算，並進一步確認，我沒有對 \n{EmpInfo.CompanyName}\n 及其附屬公司有其他索償請求。
Name of Scheme=計劃名稱
Scheme Registration No.=計劃註冊編號
Name of Contact Person=聯絡人姓名
Telephone No.=電話號碼
Existing Employee Section=現有僱員部分
Name of Employee=僱員姓名
YYYY/MM/DD=年年年年/月月/日日
Mandatory Contributions=強積金供款
Voluntary Contributions=自願性供款
Employer 5%=僱主 5%
Employee 5%=僱員 5%
Term Code=離職代號
Employee entitlement=僱員應獲得的總額
Please Specify LSP or SP=請註明長期服務金或遺散費
LSP/SP paid or to be paid to employee by Employer=已/將由僱主支付予僱員之長期服務金/遺散費
New Employee Section=新入職僱員部分
For your convenience, we have provided the mandatory contribution details below based on the relevant income from your last settled Remittance Statement.=為了你的使用更為方便，從強積金付款結算書中我們提供了以下基於有關收入而所計算的強制性供款。
If the data for the current contribution period is different, please delete it and insert the correct amount.=假若現時的供款期有所更改，請刪除並重新輸入正確的金額。
FINAL PAYMENT CALCULATION:=最後工資計算結果:
Termination codes=離職代號
WB - Withdrawal=辭職
RE - Redundancy=裁員
DS - Summary dismissal=即時革職
ER - Early retirement=提早退休
NR - Normal retirement=正式退休
LR - Late retirement=延遲退休
PC - Termination prior to commencement of contribution=開始供款前離職
DN - Death=死亡
GO - Member transfer between companies=成員於公司之間調職
PD - Permanent departure from Hong Kong=永久性地離開香港
TI - Total incapacity=完全喪失行為能力
(please provide your employee with a letter certifying that his/her contract of employment for that particular kind of work has been or will be terminated)=（請為僱員提供由貴公司發出的信件，證明他／她就該特定工作的僱傭合約己予或將予終止）
First Name=名字
Name (in English)=姓名 (英文)
Sex (M/F)=性別 (男／女)
Identitiy Type=證件類別
This section is only applicable for reporting employees who have been employed for 60 days (for non-casual employees) / 10days (for casual employees) but are not shown in the 'Existing Employees section'.=本部分僅適用於員工工作日剛滿60天（非臨時僱員）/10天的臨時僱員，但不顯示在“現有僱員項”的報告。
Please report relevant income and contributions for EACH contribution period .=請報告的每一供款期的有關入息及供款。
Additional Employee Termination Information Section=額外離職僱員資料部分
Identitiy No=證件號碼
Member Type=成員類別
Date joined scheme=參加計劃日期
ClassNo=級別號碼
For reporting termination of employees in the 'New Employees section', please leave the 'Last payroll details' blank.=如匯報任何新僱員部分的僱員之離職詳情, 請毋須填寫"最後受薪詳情"。
Please report relevant income and contributions for EACH contribution period.=請提供僱員每一個供款期的有關入息及供款。
Last Contribution Period=最後供款期
HKID / Passport=香港身分證／護照號碼
Last payroll details=最後受薪詳情
Employee entitlemnt (Please specify LSP or SP)=僱員應獲得的總額（請註明長期服務金或遣散費）
LSP/SP paid or to be paid employee by Employer=已／將由僱主支付予僱員之長期服務金／遣散費
Back-payment for Terminated Employee Section=已離職僱員的補薪部分
This section is only applicable for reporting any back-payment made to employees whose termination has previously been reported.=此部分只適用於為之前已作出通知的離職僱員而匯報的任何補薪。
Subtotal=小計
Display Code Only=只顯示代號
Normal=日更
Overnight=通宵更
Statutory Holiday=法定假期
Settings for Plain Text/CSV=CSV及文字檔設定
Use settings under Roster Code if available =使用當值時間表的工作小時
Emp. No=僱員編號
Start Date for Leave Application History=休假申請顯示開始日
Start Date for Pay Slip Printing=支薪通知書顯示開始日
Automatically release the Pay Slip to ESS=自動發放支薪通知書到僱員自助系統
Create (temporary) attendance record if record does not exists=將建立一個暫時的考勤紀錄假如本身的紀錄並不存在
Add:=支付項目:
Deduct:=扣減項目:
Customer ID:=客戶編號:
First Period Leave Cut Off Day=第一周期休假截數日
Second Period Start Day=第二周期開始日
Second Period Leave Cut Off Day=第二周期休假截數日
Semi-Monthly=每半月
Deduction Formula:=扣減公式:
Allowance Formula:=津貼公式:
Payment Code for Deduction:=扣減的支薪代號:
Payment Code for Allowance:=津貼的支薪代號:
Leave Calculation Override=休假計算依支薪組別設定
INBOX_SIZE_EXCEEDED=已超越收件匣容量上限, 請刪除部份信息
User Guide=使用手冊
PARAM_CODE_HKID_CHECKDIGIT_AUTO_GENERATE=自動產生香港身分証的驗証碼
Inbox size used=已使用的收件匣空間
Use Public Holiday Table instead of Statutory Holiday Table=用公眾假期表取代法定假期表
Request Cancel due to No Authorizer for this employee=由於沒有批核者, 申請取消
Internal Email=內部電郵
Request From=申請要求日期
Submit Date=遞交日期
Modify Date=修改日期
Request Type=申請類型
Authorize=批准
Reject=拒絕
Request Cancel due to No Authorizer=由於沒有批核者, 申請取消
Submit=遞交
Leave Balance Enquiry=查詢休假結餘
Leave History Enquiry=查詢休假紀錄
Request Status=申請狀況
Payslip Printing=列印支薪通知書
Request Employee Info Changes=更改僱員資料申請
Date of Submit=提交日期
Preview=預覽
REQUEESTSTATUS_ALL=全部
REQUEESTSTATUS_PROCESSING=處理中
REQUEESTSTATUS_END_PROCESS=接受/拒絕/取消
The leave application is cancelled=假期申請已經取消
Reason=原因
Expired=過期
Will expire=將會過期
Leave Application Cancellation=取消假期申請
Application Approval=批核申請
Delegate Employee No.=委任(偏員編號)
Awaiting your approval=等候批核
Awaiting other groups approval=等候其他組別批核
Approval History=批核紀錄
Submitted=已提交
Action Date=操作日期
Leave Balance Report=休假結餘報表
ESS_EmpLeaveBalanceReport.AsOfDate=直至
Tax Report Printing=列印稅務報表
Current entitlement is not available for leave applications=本年度應得假期將不可申請
Cancel Leave Application=取消已批假期
Date Expiry=有效日期
ESS Options=僱員自助服務設定
Hide Leave Balance in ESS=隱藏休假結餘
Do not allow to apply leave application if the employee does not have enough leave balance as at=在以的情況如果僱員的休假結餘不足申請假期將不被接納
date of submit=遞交申請時
first date of leave application=首天放假
last date of leave application=放假的最後一天
last date of leave year=年度的最後一天
Show Medical Cert. Option=顯示醫生紙選擇
Enable Public Holiday Entitlement in Employee Leave Balance=在休假結餘裡啟用公眾假期日數獲取
Max. B/F=最多帶假
Day(s)=日
Expiry after=有效期
Month(s)=個月
Import Compensation Leave Entitlement=導入補假獲得
second formula for comparsion:=比較款額
Release Tax Report to ESS=發放稅務報表到僱員自助系統
Pay Slip Report (Dot Matrix)=支薪通知書(電話密碼紙版)
Authorization Workflow Setup=批核流程設定
ESS Authorization Workflow Setup=僱員自助服務批核流程設定
Reason for Cancel=取消原因
Cancelled=已取消
Public Holiday Options=公眾假期選項
Re-Calculate All Staff's Leave Balance=重新設算本計劃內員工假期結算
ESS_EmpLeaveApplicationList.PeriodFrom=日期 由
ESS_EmpLeaveApplicationList.PeriodTo=至
Payroll allocation report - details=薪金配置詳細報告

KHL_CPSL.Seq=#
KHL_CPSL.EmpNo=僱員編號 
KHL_CPSL.EnglishName=名稱
KHL_CPSL.Position=職位
KHL_CPSL.DateJoin=入職日期
KHL_CPSL.NetPayment=淨薪金
KHL_CPSL.RelevantIncome=有關入息 
KHL_CPSL.NonRelevantIncome=非有關入息
KHL_CPSL.WagesPayableForMinWages=最低工資條例下須支付的工資
KHL_CPSL.TotalHoursWorked=總工時
KHL_CPSL.MinWagesRequired=法例要求的最低工資
KHL_CPSL.EmployerMandatoryContribution=僱主強積金供款
KHL_CPSL.EmployerVoluntaryContribution=僱主自願性供款
KHL_CPSL.EmployerPFundContribution=僱主公積金供款
KHL_CPSL.TotalEmployerContribution=僱主總供款
KHL_CPSL.TotalEmployeeContribution=僱員總供款
KHL_CPSL.TotalTaxablePayment=總課稅額
KHL_CPSL.TotalNonTaxablePayment=總非課稅額

PROOM_CPSL.Company=公司
PROOM_CPSL.EmpNo=僱員編號
PROOM_CPSL.EnglishName=名稱
PROOM_CPSL.Alias=別名
PROOM_CPSL.HKID=身份証編號
PROOM_CPSL.JoinDate=入職日期
PROOM_CPSL.ServiceStartDate=服務日期
PROOM_CPSL.Position=職位
PROOM_CPSL.CurrentBasicSalary=現時基本薪酬
PROOM_CPSL.HeadCount=僱員人數
PROOM_CPSL.NetPayment=淨薪金
PROOM_CPSL.EmployerMandatoryContribution=僱主強積金供款
PROOM_CPSL.TotalMandatoryContribution=總強積金供款
PROOM_CPSL.RelevantIncome=有關入息
PROOM_CPSL.NonRelevantIncome=非有關入息

Benefit Plan Setup=褔利計劃設定
Benefit=褔利
Beneficiaries=受益人
Incentive Payment Process=獎勵金程序
Bonus Process=獎金程序
Double Pay=雙糧
Cost Center Export Report=導出成本中心報告
Living Apart=分居
Commission Achievement Process=佣金成就計算
Double Pay Adjustment=雙糧調整

Cancelled Leave Application=已取消的休假申請
EmergencyContact=緊急聯絡資料
Disabled=已停止
Leave Application Unit=申請休假單位
Show Relevant Cert. Option=是否須要出示有關証明書
Deduction Formula=扣除公式
Payment code for deduction=扣減的支薪代號
Allowance Formula=津貼公式
Payment code for allowance=津貼的支薪代號
Remote Profile for HSBC/Hang Seng=恒生或匯豐的遠程配置文件編號
Bank=銀行
remote Profile ID=遠程配置文件編號
Signed by=簽署
Auto generate Staff Number=自動產生員工編號
New Staff Number format=新員工格式
{9} - any digit, {Other Characters} - any fixed character. e.g. Format = A-99999 means the staff number starts with 'A-' and with 5 digit, where 'A-00301' is a valid staff number.={9} - 任何数字，{其他字符} - 任何固定的字符。例如格式= A-99999是指以'A-'，并与5位数字，其中“A-00301”是一個有效的员工編號。
PayScale Master=總薪級表
PayScale Points Master=總點數薪級表
Payscale - Salary Increment Batch=薪級表 - 加薪批次
Payscale - Backpay Template Export=薪級表 -補發工資範本導出
F&V Monthly Achievement=每月成就
e-channel Signature Setup=設定電子渠道的簽署
Employee Benefit=員工福利
Employee Beneficiaries=福利受益人
Monthly Achievement=每月達成率
Incentive Payment=鼓勵款項
Import Compensation Leave Entitlement=導入補償休假權利
File Format=文件格式
Applied to=適用於
Generate Claims And Deduction=製作索償與扣減

Import Batch=導入批次
Payment Date=支薪日期
Import Commission Achievement=導入佣金成就
Commission Achievement Import History=佣金成就導入紀錄
Export Commission Achievement Template=導出佣金成就範本
Export Claims And Deduction Template for Commission Achievement=製作索償與扣減(佣金成就)

Import Incentive Payment=導入鼓勵款項
Incentive Payment Import History=鼓勵款項導入紀錄
Export Incentive Payment Template=導出鼓勵款項範本
Export Claims And Deduction Template for Incentive Payment=製作索償與扣減(鼓勵款項)

Double Pay Adjustment Process=雙糧修訂
Commission Employee List=佣金制度員工列表
Import Double Pay Adjustment=導入雙糧修訂
Double Pay Adjustment Import History=雙糧修訂導入紀錄
Export Claims And Deduction Template for Double Pay Adjustment=製作索償與扣減(雙糧修訂)

Select Employee=選取員工

(Disabled)=(停用)
Overall Payment Summary=整體支薪摘要
CL Requisition=補假申請
CL Requisition History=補假申請紀錄
Late Waive=撤回遲到申請
Late Waive History=撤回遲到申請紀錄

Monthly Attendance Report=每月考勤報表
Input in/out Time=輸入上/下班時間
Timecard Record=打咭紀錄
Leave Application List=休假申請紀錄

CL Requisition=補假申請
CL Requisition History=補假申請紀錄

HKID is already input in system, click SAVE button again to bypass this warning and save to database=香港身份證號碼已被用於另一位員工使用，如要儲存，請按「確定」後再按「儲存」鍵一次

User Setting=用戶設定